accumulatedFirstCnt,accumulatedSecondCnt,baseDate,firstCnt,secondCnt,sido,totalFirstCnt,totalSecondCnt
449535,0,2021-03-11 00:00:00,51100,0,전국,500635,0
61232,0,2021-03-11 00:00:00,12595,0,서울특별시,73827,0
36734,0,2021-03-11 00:00:00,3311,0,부산광역시,40045,0
23101,0,2021-03-11 00:00:00,2310,0,대구광역시,25411,0
23879,0,2021-03-11 00:00:00,1791,0,인천광역시,25670,0
20280,0,2021-03-11 00:00:00,2403,0,광주광역시,22683,0
12573,0,2021-03-11 00:00:00,1952,0,대전광역시,14525,0
8836,0,2021-03-11 00:00:00,434,0,울산광역시,9270,0
794,0,2021-03-11 00:00:00,66,0,세종특별자치시,860,0
95915,0,2021-03-11 00:00:00,9961,0,경기도,105876,0
12163,0,2021-03-11 00:00:00,2627,0,강원도,14790,0
14207,0,2021-03-11 00:00:00,1167,0,충청북도,15374,0
21895,0,2021-03-11 00:00:00,2379,0,충청남도,24274,0
22684,0,2021-03-11 00:00:00,2485,0,전라북도,25169,0
23030,0,2021-03-11 00:00:00,2718,0,전라남도,25748,0
26070,0,2021-03-11 00:00:00,2365,0,경상북도,28435,0
41812,0,2021-03-11 00:00:00,2036,0,경상남도,43848,0
4330,0,2021-03-11 00:00:00,500,0,제주특별자치도,4830,0
503750,0,2021-03-12 00:00:00,42527,0,전국,546277,0
74892,0,2021-03-12 00:00:00,10972,0,서울특별시,85864,0
40159,0,2021-03-12 00:00:00,2620,0,부산광역시,42779,0
25500,0,2021-03-12 00:00:00,1834,0,대구광역시,27334,0
26254,0,2021-03-12 00:00:00,2294,0,인천광역시,28548,0
14528,0,2021-03-12 00:00:00,1482,0,대전광역시,16010,0
22804,0,2021-03-12 00:00:00,1439,0,광주광역시,24243,0
860,0,2021-03-12 00:00:00,201,0,세종특별자치시,1061,0
9270,0,2021-03-12 00:00:00,429,0,울산광역시,9699,0
106518,0,2021-03-12 00:00:00,9516,0,경기도,116034,0
14830,0,2021-03-12 00:00:00,2314,0,강원도,17144,0
15404,0,2021-03-12 00:00:00,770,0,충청북도,16174,0
24285,0,2021-03-12 00:00:00,1246,0,충청남도,25531,0
25175,0,2021-03-12 00:00:00,1050,0,전라북도,26225,0
26091,0,2021-03-12 00:00:00,2202,0,전라남도,28293,0
28439,0,2021-03-12 00:00:00,2158,0,경상북도,30597,0
43911,0,2021-03-12 00:00:00,1452,0,경상남도,45363,0
4830,0,2021-03-12 00:00:00,548,0,제주특별자치도,5378,0
547974,0,2021-03-13 00:00:00,35684,0,전국,583658,0
86342,0,2021-03-13 00:00:00,9654,0,서울특별시,95996,0
42863,0,2021-03-13 00:00:00,2748,0,부산광역시,45611,0
27449,0,2021-03-13 00:00:00,1435,0,대구광역시,28884,0
28560,0,2021-03-13 00:00:00,2041,0,인천광역시,30601,0
24256,0,2021-03-13 00:00:00,1060,0,광주광역시,25316,0
16073,0,2021-03-13 00:00:00,1210,0,대전광역시,17283,0
1061,0,2021-03-13 00:00:00,85,0,세종특별자치시,1146,0
116706,0,2021-03-13 00:00:00,9001,0,경기도,125707,0
9700,0,2021-03-13 00:00:00,471,0,울산광역시,10171,0
17145,0,2021-03-13 00:00:00,1336,0,강원도,18481,0
16183,0,2021-03-13 00:00:00,569,0,충청북도,16752,0
25533,0,2021-03-13 00:00:00,769,0,충청남도,26302,0
26225,0,2021-03-13 00:00:00,636,0,전라북도,26861,0
28379,0,2021-03-13 00:00:00,1608,0,전라남도,29987,0
30753,0,2021-03-13 00:00:00,1468,0,경상북도,32221,0
45366,0,2021-03-13 00:00:00,1236,0,경상남도,46602,0
5380,0,2021-03-13 00:00:00,357,0,제주특별자치도,5737,0
584397,0,2021-03-14 00:00:00,3487,0,전국,587884,0
96073,0,2021-03-14 00:00:00,1704,0,서울특별시,97777,0
45681,0,2021-03-14 00:00:00,187,0,부산광역시,45868,0
28884,0,2021-03-14 00:00:00,134,0,대구광역시,29018,0
25320,0,2021-03-14 00:00:00,109,0,광주광역시,25429,0
30647,0,2021-03-14 00:00:00,79,0,인천광역시,30726,0
17283,0,2021-03-14 00:00:00,66,0,대전광역시,17349,0
10171,0,2021-03-14 00:00:00,0,0,울산광역시,10171,0
1146,0,2021-03-14 00:00:00,0,0,세종특별자치시,1146,0
126067,0,2021-03-14 00:00:00,744,0,경기도,126811,0
18481,0,2021-03-14 00:00:00,72,0,강원도,18553,0
16752,0,2021-03-14 00:00:00,35,0,충청북도,16787,0
26314,0,2021-03-14 00:00:00,0,0,충청남도,26314,0
26861,0,2021-03-14 00:00:00,57,0,전라북도,26918,0
30154,0,2021-03-14 00:00:00,41,0,전라남도,30195,0
32224,0,2021-03-14 00:00:00,127,0,경상북도,32351,0
46602,0,2021-03-14 00:00:00,132,0,경상남도,46734,0
5737,0,2021-03-14 00:00:00,0,0,제주특별자치도,5737,0
587884,0,2021-03-15 00:00:00,1074,0,전국,588958,0
97777,0,2021-03-15 00:00:00,900,0,서울특별시,98677,0
45868,0,2021-03-15 00:00:00,0,0,부산광역시,45868,0
29018,0,2021-03-15 00:00:00,10,0,대구광역시,29028,0
17349,0,2021-03-15 00:00:00,0,0,대전광역시,17349,0
30726,0,2021-03-15 00:00:00,8,0,인천광역시,30734,0
25429,0,2021-03-15 00:00:00,11,0,광주광역시,25440,0
1146,0,2021-03-15 00:00:00,0,0,세종특별자치시,1146,0
10171,0,2021-03-15 00:00:00,0,0,울산광역시,10171,0
126811,0,2021-03-15 00:00:00,92,0,경기도,126903,0
18553,0,2021-03-15 00:00:00,0,0,강원도,18553,0
16787,0,2021-03-15 00:00:00,0,0,충청북도,16787,0
26314,0,2021-03-15 00:00:00,22,0,충청남도,26336,0
26918,0,2021-03-15 00:00:00,0,0,전라북도,26918,0
30195,0,2021-03-15 00:00:00,0,0,전라남도,30195,0
32351,0,2021-03-15 00:00:00,0,0,경상북도,32351,0
46734,0,2021-03-15 00:00:00,31,0,경상남도,46765,0
5737,0,2021-03-15 00:00:00,0,0,제주특별자치도,5737,0
590228,0,2021-03-16 00:00:00,11922,0,전국,602150,0
99141,0,2021-03-16 00:00:00,3293,0,서울특별시,102434,0
45936,0,2021-03-16 00:00:00,878,0,부산광역시,46814,0
29134,0,2021-03-16 00:00:00,358,0,대구광역시,29492,0
17396,0,2021-03-16 00:00:00,429,0,대전광역시,17825,0
30759,0,2021-03-16 00:00:00,501,0,인천광역시,31260,0
25440,0,2021-03-16 00:00:00,339,0,광주광역시,25779,0
1146,0,2021-03-16 00:00:00,0,0,세종특별자치시,1146,0
127365,0,2021-03-16 00:00:00,2798,0,경기도,130163,0
10211,0,2021-03-16 00:00:00,130,0,울산광역시,10341,0
18554,0,2021-03-16 00:00:00,654,0,강원도,19208,0
16794,0,2021-03-16 00:00:00,248,0,충청북도,17042,0
26348,0,2021-03-16 00:00:00,247,0,충청남도,26595,0
26918,0,2021-03-16 00:00:00,246,0,전라북도,27164,0
30226,0,2021-03-16 00:00:00,563,0,전라남도,30789,0
32354,0,2021-03-16 00:00:00,671,0,경상북도,33025,0
46769,0,2021-03-16 00:00:00,454,0,경상남도,47223,0
5737,0,2021-03-16 00:00:00,113,0,제주특별자치도,5850,0
603451,0,2021-03-17 00:00:00,18283,0,전국,621734,0
102849,0,2021-03-17 00:00:00,3117,0,서울특별시,105966,0
46911,0,2021-03-17 00:00:00,1969,0,부산광역시,48880,0
29636,0,2021-03-17 00:00:00,447,0,대구광역시,30083,0
31305,0,2021-03-17 00:00:00,1057,0,인천광역시,32362,0
17895,0,2021-03-17 00:00:00,752,0,대전광역시,18647,0
25818,0,2021-03-17 00:00:00,455,0,광주광역시,26273,0
1146,0,2021-03-17 00:00:00,219,0,세종특별자치시,1365,0
130457,0,2021-03-17 00:00:00,4421,0,경기도,134878,0
10380,0,2021-03-17 00:00:00,909,0,울산광역시,11289,0
19234,0,2021-03-17 00:00:00,578,0,강원도,19812,0
17043,0,2021-03-17 00:00:00,319,0,충청북도,17362,0
26596,0,2021-03-17 00:00:00,349,0,충청남도,26945,0
27164,0,2021-03-17 00:00:00,432,0,전라북도,27596,0
30792,0,2021-03-17 00:00:00,683,0,전라남도,31475,0
33100,0,2021-03-17 00:00:00,1056,0,경상북도,34156,0
47275,0,2021-03-17 00:00:00,710,0,경상남도,47985,0
5850,0,2021-03-17 00:00:00,810,0,제주특별자치도,6660,0
622598,0,2021-03-18 00:00:00,18733,0,전국,641331,0
106182,0,2021-03-18 00:00:00,3354,0,서울특별시,109536,0
49352,0,2021-03-18 00:00:00,1636,0,부산광역시,50988,0
30095,0,2021-03-18 00:00:00,1045,0,대구광역시,31140,0
32363,0,2021-03-18 00:00:00,1657,0,인천광역시,34020,0
26273,0,2021-03-18 00:00:00,335,0,광주광역시,26608,0
11311,0,2021-03-18 00:00:00,864,0,울산광역시,12175,0
18647,0,2021-03-18 00:00:00,1343,0,대전광역시,19990,0
134938,0,2021-03-18 00:00:00,3394,0,경기도,138332,0
1365,0,2021-03-18 00:00:00,235,0,세종특별자치시,1600,0
19863,0,2021-03-18 00:00:00,275,0,강원도,20138,0
17362,0,2021-03-18 00:00:00,1003,0,충청북도,18365,0
26945,0,2021-03-18 00:00:00,127,0,충청남도,27072,0
27597,0,2021-03-18 00:00:00,501,0,전라북도,28098,0
31489,0,2021-03-18 00:00:00,722,0,전라남도,32211,0
34157,0,2021-03-18 00:00:00,1042,0,경상북도,35199,0
47998,0,2021-03-18 00:00:00,582,0,경상남도,48580,0
6661,0,2021-03-18 00:00:00,618,0,제주특별자치도,7279,0
641974,0,2021-03-19 00:00:00,17501,0,전국,659475,0
109947,0,2021-03-19 00:00:00,3002,0,서울특별시,112949,0
51017,0,2021-03-19 00:00:00,1349,0,부산광역시,52366,0
31143,0,2021-03-19 00:00:00,768,0,대구광역시,31911,0
34072,0,2021-03-19 00:00:00,1714,0,인천광역시,35786,0
26608,0,2021-03-19 00:00:00,382,0,광주광역시,26990,0
12175,0,2021-03-19 00:00:00,735,0,울산광역시,12910,0
1600,0,2021-03-19 00:00:00,189,0,세종특별자치시,1789,0
19990,0,2021-03-19 00:00:00,1082,0,대전광역시,21072,0
20139,0,2021-03-19 00:00:00,548,0,강원도,20687,0
138442,0,2021-03-19 00:00:00,3086,0,경기도,141528,0
18368,0,2021-03-19 00:00:00,1142,0,충청북도,19510,0
27073,0,2021-03-19 00:00:00,403,0,충청남도,27476,0
28098,0,2021-03-19 00:00:00,471,0,전라북도,28569,0
32224,0,2021-03-19 00:00:00,539,0,전라남도,32763,0
35219,0,2021-03-19 00:00:00,849,0,경상북도,36068,0
48580,0,2021-03-19 00:00:00,618,0,경상남도,49198,0
7279,0,2021-03-19 00:00:00,624,0,제주특별자치도,7903,0
660294,0,2021-03-20 00:00:00,15132,0,전국,675426,0
113075,0,2021-03-20 00:00:00,3935,0,서울특별시,117010,0
52370,0,2021-03-20 00:00:00,1208,0,부산광역시,53578,0
31912,0,2021-03-20 00:00:00,670,0,대구광역시,32582,0
35788,0,2021-03-20 00:00:00,1672,0,인천광역시,37460,0
21081,0,2021-03-20 00:00:00,517,0,대전광역시,21598,0
26993,0,2021-03-20 00:00:00,395,0,광주광역시,27388,0
1789,0,2021-03-20 00:00:00,106,0,세종특별자치시,1895,0
141952,0,2021-03-20 00:00:00,2390,0,경기도,144342,0
12931,0,2021-03-20 00:00:00,790,0,울산광역시,13721,0
20687,0,2021-03-20 00:00:00,498,0,강원도,21185,0
19511,0,2021-03-20 00:00:00,874,0,충청북도,20385,0
27477,0,2021-03-20 00:00:00,103,0,충청남도,27580,0
28569,0,2021-03-20 00:00:00,342,0,전라북도,28911,0
32778,0,2021-03-20 00:00:00,369,0,전라남도,33147,0
36083,0,2021-03-20 00:00:00,441,0,경상북도,36524,0
49367,0,2021-03-20 00:00:00,522,0,경상남도,49889,0
7931,0,2021-03-20 00:00:00,300,0,제주특별자치도,8231,0
675648,0,2021-03-21 00:00:00,939,313,전국,676587,313
117035,0,2021-03-21 00:00:00,13,313,서울특별시,117048,313
53584,0,2021-03-21 00:00:00,46,0,부산광역시,53630,0
32631,0,2021-03-21 00:00:00,223,0,대구광역시,32854,0
37469,0,2021-03-21 00:00:00,382,0,인천광역시,37851,0
27388,0,2021-03-21 00:00:00,0,0,광주광역시,27388,0
13721,0,2021-03-21 00:00:00,0,0,울산광역시,13721,0
21598,0,2021-03-21 00:00:00,194,0,대전광역시,21792,0
1895,0,2021-03-21 00:00:00,0,0,세종특별자치시,1895,0
144403,0,2021-03-21 00:00:00,59,0,경기도,144462,0
21185,0,2021-03-21 00:00:00,0,0,강원도,21185,0
20385,0,2021-03-21 00:00:00,0,0,충청북도,20385,0
27581,0,2021-03-21 00:00:00,12,0,충청남도,27593,0
28911,0,2021-03-21 00:00:00,10,0,전라북도,28921,0
33147,0,2021-03-21 00:00:00,0,0,전라남도,33147,0
36595,0,2021-03-21 00:00:00,0,0,경상북도,36595,0
49889,0,2021-03-21 00:00:00,0,0,경상남도,49889,0
8231,0,2021-03-21 00:00:00,0,0,제주특별자치도,8231,0
676606,313,2021-03-22 00:00:00,1,280,전국,676607,593
117048,313,2021-03-22 00:00:00,0,280,서울특별시,117048,593
53630,0,2021-03-22 00:00:00,0,0,부산광역시,53630,0
37869,0,2021-03-22 00:00:00,1,0,인천광역시,37870,0
32854,0,2021-03-22 00:00:00,0,0,대구광역시,32854,0
21792,0,2021-03-22 00:00:00,0,0,대전광역시,21792,0
13721,0,2021-03-22 00:00:00,0,0,울산광역시,13721,0
27388,0,2021-03-22 00:00:00,0,0,광주광역시,27388,0
144462,0,2021-03-22 00:00:00,0,0,경기도,144462,0
1895,0,2021-03-22 00:00:00,0,0,세종특별자치시,1895,0
21185,0,2021-03-22 00:00:00,0,0,강원도,21185,0
20385,0,2021-03-22 00:00:00,0,0,충청북도,20385,0
27593,0,2021-03-22 00:00:00,0,0,충청남도,27593,0
28921,0,2021-03-22 00:00:00,0,0,전라북도,28921,0
33147,0,2021-03-22 00:00:00,0,0,전라남도,33147,0
36596,0,2021-03-22 00:00:00,0,0,경상북도,36596,0
49889,0,2021-03-22 00:00:00,0,0,경상남도,49889,0
8231,0,2021-03-22 00:00:00,0,0,제주특별자치도,8231,0
677856,593,2021-03-23 00:00:00,2704,290,전국,680560,883
116310,509,2021-03-23 00:00:00,802,255,서울특별시,117112,764
53674,0,2021-03-23 00:00:00,287,0,부산광역시,53961,0
32948,0,2021-03-23 00:00:00,166,0,대구광역시,33114,0
38172,43,2021-03-23 00:00:00,151,16,인천광역시,38323,59
21754,0,2021-03-23 00:00:00,101,0,대전광역시,21855,0
27122,0,2021-03-23 00:00:00,0,0,광주광역시,27122,0
145295,41,2021-03-23 00:00:00,592,18,경기도,145887,59
13657,0,2021-03-23 00:00:00,28,0,울산광역시,13685,0
21374,0,2021-03-23 00:00:00,98,1,강원도,21472,1
1946,0,2021-03-23 00:00:00,0,0,세종특별자치시,1946,0
20449,0,2021-03-23 00:00:00,150,0,충청북도,20599,0
27566,0,2021-03-23 00:00:00,12,0,충청남도,27578,0
28974,0,2021-03-23 00:00:00,84,0,전라북도,29058,0
33395,0,2021-03-23 00:00:00,41,0,전라남도,33436,0
36698,0,2021-03-23 00:00:00,122,0,경상북도,36820,0
49950,0,2021-03-23 00:00:00,20,0,경상남도,49970,0
8310,0,2021-03-23 00:00:00,50,0,제주특별자치도,8360,0
262,0,2021-03-23 00:00:00,0,0,기타,262,0
683461,883,2021-03-24 00:00:00,20151,615,전국,703612,1498
117581,764,2021-03-24 00:00:00,1537,519,서울특별시,119118,1283
54369,0,2021-03-24 00:00:00,2444,0,부산광역시,56813,0
39162,59,2021-03-24 00:00:00,856,56,인천광역시,40018,115
33245,0,2021-03-24 00:00:00,840,0,대구광역시,34085,0
22040,0,2021-03-24 00:00:00,399,0,대전광역시,22439,0
13692,0,2021-03-24 00:00:00,548,0,울산광역시,14240,0
27143,0,2021-03-24 00:00:00,1937,0,광주광역시,29080,0
2056,0,2021-03-24 00:00:00,71,0,세종특별자치시,2127,0
21474,1,2021-03-24 00:00:00,195,4,강원도,21669,5
20692,0,2021-03-24 00:00:00,335,0,충청북도,21027,0
146289,59,2021-03-24 00:00:00,2936,36,경기도,149225,95
27768,0,2021-03-24 00:00:00,818,0,충청남도,28586,0
29141,0,2021-03-24 00:00:00,2163,0,전라북도,31304,0
33533,0,2021-03-24 00:00:00,1981,0,전라남도,35514,0
36895,0,2021-03-24 00:00:00,728,0,경상북도,37623,0
50021,0,2021-03-24 00:00:00,2259,0,경상남도,52280,0
8360,0,2021-03-24 00:00:00,104,0,제주특별자치도,8464,0
704902,1498,2021-03-25 00:00:00,28222,1193,전국,733124,2691
119527,1283,2021-03-25 00:00:00,2722,442,서울특별시,122249,1725
56908,0,2021-03-25 00:00:00,3756,62,부산광역시,60664,62
34109,0,2021-03-25 00:00:00,1159,217,대구광역시,35268,217
40077,115,2021-03-25 00:00:00,2042,58,인천광역시,42119,173
29151,0,2021-03-25 00:00:00,1837,15,광주광역시,30988,15
14256,0,2021-03-25 00:00:00,804,0,울산광역시,15060,0
22471,0,2021-03-25 00:00:00,848,0,대전광역시,23319,0
2127,0,2021-03-25 00:00:00,159,0,세종특별자치시,2286,0
149355,95,2021-03-25 00:00:00,4484,79,경기도,153839,174
21672,5,2021-03-25 00:00:00,638,21,강원도,22310,26
21114,0,2021-03-25 00:00:00,1061,24,충청북도,22175,24
28599,0,2021-03-25 00:00:00,797,80,충청남도,29396,80
31309,0,2021-03-25 00:00:00,2116,23,전라북도,33425,23
35671,0,2021-03-25 00:00:00,2163,67,전라남도,37834,67
37623,0,2021-03-25 00:00:00,955,0,경상북도,38578,0
52468,0,2021-03-25 00:00:00,2535,105,경상남도,55003,105
8465,0,2021-03-25 00:00:00,146,0,제주특별자치도,8611,0
734985,2691,2021-03-26 00:00:00,32466,1142,전국,767451,3833
122750,1725,2021-03-26 00:00:00,4629,446,서울특별시,127379,2171
60861,62,2021-03-26 00:00:00,3211,48,부산광역시,64072,110
35324,217,2021-03-26 00:00:00,1207,202,대구광역시,36531,419
42169,173,2021-03-26 00:00:00,1814,47,인천광역시,43983,220
31153,15,2021-03-26 00:00:00,1648,12,광주광역시,32801,27
23330,0,2021-03-26 00:00:00,746,0,대전광역시,24076,0
15095,0,2021-03-26 00:00:00,626,32,울산광역시,15721,32
2286,0,2021-03-26 00:00:00,90,0,세종특별자치시,2376,0
154341,174,2021-03-26 00:00:00,6277,49,경기도,160618,223
22309,26,2021-03-26 00:00:00,913,20,강원도,23222,46
22198,24,2021-03-26 00:00:00,1227,15,충청북도,23425,39
29419,80,2021-03-26 00:00:00,2022,62,충청남도,31441,142
33437,23,2021-03-26 00:00:00,2428,25,전라북도,35865,48
37956,67,2021-03-26 00:00:00,1377,75,전라남도,39333,142
38669,0,2021-03-26 00:00:00,1467,0,경상북도,40136,0
55052,105,2021-03-26 00:00:00,2629,109,경상남도,57681,214
8636,0,2021-03-26 00:00:00,155,0,제주특별자치도,8791,0
769429,3833,2021-03-27 00:00:00,22845,1399,전국,792274,5232
128061,2171,2021-03-27 00:00:00,4735,468,서울특별시,132796,2639
64310,110,2021-03-27 00:00:00,1863,52,부산광역시,66173,162
36557,419,2021-03-27 00:00:00,781,240,대구광역시,37338,659
44096,220,2021-03-27 00:00:00,1713,37,인천광역시,45809,257
24233,0,2021-03-27 00:00:00,520,0,대전광역시,24753,0
32812,27,2021-03-27 00:00:00,907,52,광주광역시,33719,79
15748,32,2021-03-27 00:00:00,480,0,울산광역시,16228,32
2376,0,2021-03-27 00:00:00,40,0,세종특별자치시,2416,0
160944,223,2021-03-27 00:00:00,4733,39,경기도,165677,262
23223,46,2021-03-27 00:00:00,753,26,강원도,23976,72
23509,39,2021-03-27 00:00:00,821,22,충청북도,24330,61
31552,142,2021-03-27 00:00:00,1570,196,충청남도,33122,338
35950,48,2021-03-27 00:00:00,1357,24,전라북도,37307,72
39342,142,2021-03-27 00:00:00,675,78,전라남도,40017,220
40189,0,2021-03-27 00:00:00,706,0,경상북도,40895,0
57700,214,2021-03-27 00:00:00,888,165,경상남도,58588,379
8827,0,2021-03-27 00:00:00,303,0,제주특별자치도,9130,0
792802,5232,2021-03-28 00:00:00,1056,0,전국,793858,5232
132813,2639,2021-03-28 00:00:00,180,0,서울특별시,132993,2639
66232,162,2021-03-28 00:00:00,114,0,부산광역시,66346,162
37348,659,2021-03-28 00:00:00,16,0,대구광역시,37364,659
45823,257,2021-03-28 00:00:00,3,0,인천광역시,45826,257
33736,79,2021-03-28 00:00:00,30,0,광주광역시,33766,79
24831,0,2021-03-28 00:00:00,0,0,대전광역시,24831,0
16228,32,2021-03-28 00:00:00,0,0,울산광역시,16228,32
2416,0,2021-03-28 00:00:00,0,0,세종특별자치시,2416,0
165993,262,2021-03-28 00:00:00,369,0,경기도,166362,262
23976,72,2021-03-28 00:00:00,24,0,강원도,24000,72
24330,61,2021-03-28 00:00:00,60,0,충청북도,24390,61
33132,338,2021-03-28 00:00:00,202,0,충청남도,33334,338
37307,72,2021-03-28 00:00:00,11,0,전라북도,37318,72
40017,220,2021-03-28 00:00:00,0,0,전라남도,40017,220
40902,0,2021-03-28 00:00:00,0,0,경상북도,40902,0
58588,379,2021-03-28 00:00:00,47,0,경상남도,58635,379
9130,0,2021-03-28 00:00:00,0,0,제주특별자치도,9130,0
793955,5232,2021-03-29 00:00:00,11,0,전국,793966,5232
132993,2639,2021-03-29 00:00:00,0,0,서울특별시,132993,2639
66346,162,2021-03-29 00:00:00,0,0,부산광역시,66346,162
37364,659,2021-03-29 00:00:00,0,0,대구광역시,37364,659
33766,79,2021-03-29 00:00:00,0,0,광주광역시,33766,79
45826,257,2021-03-29 00:00:00,0,0,인천광역시,45826,257
16228,32,2021-03-29 00:00:00,0,0,울산광역시,16228,32
24915,0,2021-03-29 00:00:00,0,0,대전광역시,24915,0
2416,0,2021-03-29 00:00:00,0,0,세종특별자치시,2416,0
24000,72,2021-03-29 00:00:00,0,0,강원도,24000,72
166375,262,2021-03-29 00:00:00,0,0,경기도,166375,262
24390,61,2021-03-29 00:00:00,0,0,충청북도,24390,61
33334,338,2021-03-29 00:00:00,0,0,충청남도,33334,338
37318,72,2021-03-29 00:00:00,0,0,전라북도,37318,72
40017,220,2021-03-29 00:00:00,0,0,전라남도,40017,220
40902,0,2021-03-29 00:00:00,0,0,경상북도,40902,0
58635,379,2021-03-29 00:00:00,11,0,경상남도,58646,379
9130,0,2021-03-29 00:00:00,0,0,제주특별자치도,9130,0
795910,5232,2021-03-30 00:00:00,26538,919,전국,822448,6151
134158,2639,2021-03-30 00:00:00,2553,394,서울특별시,136711,3033
66498,162,2021-03-30 00:00:00,2420,44,부산광역시,68918,206
37367,659,2021-03-30 00:00:00,927,0,대구광역시,38294,659
33801,79,2021-03-30 00:00:00,1213,61,광주광역시,35014,140
45880,257,2021-03-30 00:00:00,1282,7,인천광역시,47162,264
16277,32,2021-03-30 00:00:00,422,0,울산광역시,16699,32
25027,0,2021-03-30 00:00:00,683,0,대전광역시,25710,0
2417,0,2021-03-30 00:00:00,121,0,세종특별자치시,2538,0
166624,262,2021-03-30 00:00:00,5915,74,경기도,172539,336
24016,72,2021-03-30 00:00:00,570,143,강원도,24586,215
24395,61,2021-03-30 00:00:00,962,12,충청북도,25357,73
33399,338,2021-03-30 00:00:00,1121,58,충청남도,34520,396
37318,72,2021-03-30 00:00:00,1805,12,전라북도,39123,84
40019,220,2021-03-30 00:00:00,1739,32,전라남도,41758,252
40920,0,2021-03-30 00:00:00,2019,0,경상북도,42939,0
58664,379,2021-03-30 00:00:00,2454,82,경상남도,61118,461
9130,0,2021-03-30 00:00:00,332,0,제주특별자치도,9462,0
823795,6151,2021-03-31 00:00:00,28407,2034,전국,852202,8185
137081,3033,2021-03-31 00:00:00,2359,366,서울특별시,139440,3399
69111,206,2021-03-31 00:00:00,2272,39,부산광역시,71383,245
47199,264,2021-03-31 00:00:00,1633,443,인천광역시,48832,707
38343,659,2021-03-31 00:00:00,998,0,대구광역시,39341,659
25722,0,2021-03-31 00:00:00,888,0,대전광역시,26610,0
35025,140,2021-03-31 00:00:00,1129,51,광주광역시,36154,191
16712,32,2021-03-31 00:00:00,691,0,울산광역시,17403,32
2538,0,2021-03-31 00:00:00,20,0,세종특별자치시,2558,0
172845,336,2021-03-31 00:00:00,6619,352,경기도,179464,688
25364,73,2021-03-31 00:00:00,987,30,충청북도,26351,103
34620,396,2021-03-31 00:00:00,1638,56,충청남도,36258,452
24597,215,2021-03-31 00:00:00,509,602,강원도,25106,817
39155,84,2021-03-31 00:00:00,1635,9,전라북도,40790,93
41793,252,2021-03-31 00:00:00,1613,23,전라남도,43406,275
43039,0,2021-03-31 00:00:00,2356,0,경상북도,45395,0
61158,461,2021-03-31 00:00:00,2666,63,경상남도,63824,524
9493,0,2021-03-31 00:00:00,394,0,제주특별자치도,9887,0
853930,8187,2021-04-01 00:00:00,22643,4786,전국,876573,12973
139816,3400,2021-04-01 00:00:00,1768,2827,서울특별시,141584,6227
71617,245,2021-04-01 00:00:00,1954,0,부산광역시,73571,245
39467,659,2021-04-01 00:00:00,831,0,대구광역시,40298,659
26669,0,2021-04-01 00:00:00,622,0,대전광역시,27291,0
48884,707,2021-04-01 00:00:00,1206,538,인천광역시,50090,1245
36318,191,2021-04-01 00:00:00,687,141,광주광역시,37005,332
17409,32,2021-04-01 00:00:00,479,0,울산광역시,17888,32
2558,0,2021-04-01 00:00:00,106,0,세종특별자치시,2664,0
179842,688,2021-04-01 00:00:00,4971,691,경기도,184813,1379
25128,818,2021-04-01 00:00:00,844,168,강원도,25972,986
26352,103,2021-04-01 00:00:00,1318,0,충청북도,27670,103
36301,452,2021-04-01 00:00:00,1378,276,충청남도,37679,728
40793,93,2021-04-01 00:00:00,1466,0,전라북도,42259,93
43457,275,2021-04-01 00:00:00,1309,34,전라남도,44766,309
45523,0,2021-04-01 00:00:00,1857,6,경상북도,47380,6
63866,524,2021-04-01 00:00:00,1692,105,경상남도,65558,629
9930,0,2021-04-01 00:00:00,155,0,제주특별자치도,10085,0
877944,12974,2021-04-02 00:00:00,36125,6881,전국,914069,19855
142030,6228,2021-04-02 00:00:00,4076,2954,서울특별시,146106,9182
73717,245,2021-04-02 00:00:00,2321,0,부산광역시,76038,245
40375,659,2021-04-02 00:00:00,940,140,대구광역시,41315,799
50153,1245,2021-04-02 00:00:00,2198,893,인천광역시,52351,2138
37019,332,2021-04-02 00:00:00,1440,288,광주광역시,38459,620
27299,0,2021-04-02 00:00:00,764,0,대전광역시,28063,0
17907,32,2021-04-02 00:00:00,808,0,울산광역시,18715,32
2664,0,2021-04-02 00:00:00,406,0,세종특별자치시,3070,0
185149,1379,2021-04-02 00:00:00,6416,1571,경기도,191565,2950
25972,986,2021-04-02 00:00:00,2397,191,강원도,28369,1177
27676,103,2021-04-02 00:00:00,2342,0,충청북도,30018,103
37710,728,2021-04-02 00:00:00,2428,307,충청남도,40138,1035
42261,93,2021-04-02 00:00:00,2084,0,전라북도,44345,93
44823,309,2021-04-02 00:00:00,2093,46,전라남도,46916,355
47397,6,2021-04-02 00:00:00,1660,338,경상북도,49057,344
65706,629,2021-04-02 00:00:00,3002,153,경상남도,68708,782
10086,0,2021-04-02 00:00:00,750,0,제주특별자치도,10836,0
915498,20203,2021-04-03 00:00:00,38058,6177,전국,953556,26380
146519,9185,2021-04-03 00:00:00,4872,2203,서울특별시,151391,11388
76066,245,2021-04-03 00:00:00,2456,0,부산광역시,78522,245
41329,799,2021-04-03 00:00:00,1593,151,대구광역시,42922,950
52398,2138,2021-04-03 00:00:00,2288,1019,인천광역시,54686,3157
28068,0,2021-04-03 00:00:00,1088,0,대전광역시,29156,0
38485,620,2021-04-03 00:00:00,1736,166,광주광역시,40221,786
3100,0,2021-04-03 00:00:00,308,0,세종특별자치시,3408,0
18758,32,2021-04-03 00:00:00,1128,0,울산광역시,19886,32
191887,3292,2021-04-03 00:00:00,6393,1924,경기도,198280,5216
28412,1177,2021-04-03 00:00:00,2217,1,강원도,30629,1178
30057,103,2021-04-03 00:00:00,1958,0,충청북도,32015,103
40269,1038,2021-04-03 00:00:00,2857,149,충청남도,43126,1187
44370,93,2021-04-03 00:00:00,2190,0,전라북도,46560,93
47090,355,2021-04-03 00:00:00,2282,44,전라남도,49372,399
49132,344,2021-04-03 00:00:00,1274,408,경상북도,50406,752
68722,782,2021-04-03 00:00:00,2842,112,경상남도,71564,894
10836,0,2021-04-03 00:00:00,576,0,제주특별자치도,11412,0
953854,26761,2021-04-04 00:00:00,8229,537,전국,962083,27298
151400,11388,2021-04-04 00:00:00,178,104,서울특별시,151578,11492
78522,245,2021-04-04 00:00:00,89,0,부산광역시,78611,245
42922,950,2021-04-04 00:00:00,89,0,대구광역시,43011,950
54739,3157,2021-04-04 00:00:00,529,0,인천광역시,55268,3157
40221,786,2021-04-04 00:00:00,250,0,광주광역시,40471,786
19917,32,2021-04-04 00:00:00,394,0,울산광역시,20311,32
3408,0,2021-04-04 00:00:00,73,0,세종특별자치시,3481,0
29166,0,2021-04-04 00:00:00,156,0,대전광역시,29322,0
30632,1178,2021-04-04 00:00:00,615,0,강원도,31247,1178
32103,103,2021-04-04 00:00:00,413,0,충청북도,32516,103
198359,5597,2021-04-04 00:00:00,2440,416,경기도,200799,6013
43133,1187,2021-04-04 00:00:00,683,0,충청남도,43816,1187
46560,93,2021-04-04 00:00:00,1288,0,전라북도,47848,93
49377,399,2021-04-04 00:00:00,258,0,전라남도,49635,399
50417,752,2021-04-04 00:00:00,126,17,경상북도,50543,769
71566,894,2021-04-04 00:00:00,635,0,경상남도,72201,894
11412,0,2021-04-04 00:00:00,13,0,제주특별자치도,11425,0
962101,27298,2021-04-05 00:00:00,629,66,전국,962730,27364
151578,11492,2021-04-05 00:00:00,105,0,서울특별시,151683,11492
78611,245,2021-04-05 00:00:00,0,0,부산광역시,78611,245
55275,3157,2021-04-05 00:00:00,0,0,인천광역시,55275,3157
43011,950,2021-04-05 00:00:00,114,0,대구광역시,43125,950
29322,0,2021-04-05 00:00:00,0,0,대전광역시,29322,0
40482,786,2021-04-05 00:00:00,0,0,광주광역시,40482,786
20311,32,2021-04-05 00:00:00,0,0,울산광역시,20311,32
200800,6013,2021-04-05 00:00:00,0,42,경기도,200800,6055
31247,1178,2021-04-05 00:00:00,0,0,강원도,31247,1178
3481,0,2021-04-05 00:00:00,0,0,세종특별자치시,3481,0
32516,103,2021-04-05 00:00:00,63,0,충청북도,32579,103
43816,1187,2021-04-05 00:00:00,76,24,충청남도,43892,1211
47847,93,2021-04-05 00:00:00,260,0,전라북도,48107,93
49635,399,2021-04-05 00:00:00,0,0,전라남도,49635,399
50543,769,2021-04-05 00:00:00,0,0,경상북도,50543,769
72201,894,2021-04-05 00:00:00,11,0,경상남도,72212,894
11425,0,2021-04-05 00:00:00,0,0,제주특별자치도,11425,0
963900,27375,2021-04-06 00:00:00,35970,316,전국,999870,27691
152086,11493,2021-04-06 00:00:00,4628,0,서울특별시,156714,11493
78624,245,2021-04-06 00:00:00,1707,0,부산광역시,80331,245
43152,950,2021-04-06 00:00:00,1278,0,대구광역시,44430,950
55342,3157,2021-04-06 00:00:00,1930,59,인천광역시,57272,3216
29322,0,2021-04-06 00:00:00,842,0,대전광역시,30164,0
40507,786,2021-04-06 00:00:00,1265,0,광주광역시,41772,786
3481,0,2021-04-06 00:00:00,254,0,세종특별자치시,3735,0
201147,6065,2021-04-06 00:00:00,6963,229,경기도,208110,6294
20325,32,2021-04-06 00:00:00,1647,0,울산광역시,21972,32
31255,1178,2021-04-06 00:00:00,2096,0,강원도,33351,1178
32605,103,2021-04-06 00:00:00,1847,0,충청북도,34452,103
44001,1211,2021-04-06 00:00:00,2238,28,충청남도,46239,1239
48111,93,2021-04-06 00:00:00,2315,0,전라북도,50426,93
49690,399,2021-04-06 00:00:00,2052,0,전라남도,51742,399
50593,769,2021-04-06 00:00:00,1457,0,경상북도,52050,769
72234,894,2021-04-06 00:00:00,2731,0,경상남도,74965,894
11425,0,2021-04-06 00:00:00,720,0,제주특별자치도,12145,0
1001533,27692,2021-04-07 00:00:00,37533,5722,전국,1039066,33414
157159,11493,2021-04-07 00:00:00,5342,284,서울특별시,162501,11777
80374,245,2021-04-07 00:00:00,1873,953,부산광역시,82247,1198
44481,950,2021-04-07 00:00:00,1206,0,대구광역시,45687,950
57335,3216,2021-04-07 00:00:00,1969,478,인천광역시,59304,3694
41792,786,2021-04-07 00:00:00,1061,63,광주광역시,42853,849
22034,32,2021-04-07 00:00:00,1747,734,울산광역시,23781,766
3739,0,2021-04-07 00:00:00,202,189,세종특별자치시,3941,189
30169,0,2021-04-07 00:00:00,851,434,대전광역시,31020,434
208703,6295,2021-04-07 00:00:00,7763,1313,경기도,216466,7608
33355,1178,2021-04-07 00:00:00,2572,0,강원도,35927,1178
34550,103,2021-04-07 00:00:00,1912,94,충청북도,36462,197
46257,1239,2021-04-07 00:00:00,1852,0,충청남도,48109,1239
50441,93,2021-04-07 00:00:00,2019,97,전라북도,52460,190
51773,399,2021-04-07 00:00:00,2299,111,전라남도,54072,510
52169,769,2021-04-07 00:00:00,1511,203,경상북도,53680,972
74998,894,2021-04-07 00:00:00,2592,113,경상남도,77590,1007
12204,0,2021-04-07 00:00:00,762,656,제주특별자치도,12966,656
1039714,33416,2021-04-08 00:00:00,35860,9231,전국,1075574,42647
162588,11777,2021-04-08 00:00:00,3975,620,서울특별시,166563,12397
82302,1198,2021-04-08 00:00:00,1593,1190,부산광역시,83895,2388
45739,950,2021-04-08 00:00:00,1183,437,대구광역시,46922,1387
59294,3694,2021-04-08 00:00:00,2120,1388,인천광역시,61414,5082
31018,434,2021-04-08 00:00:00,816,973,대전광역시,31834,1407
42845,849,2021-04-08 00:00:00,1102,89,광주광역시,43947,938
23776,766,2021-04-08 00:00:00,1821,679,울산광역시,25597,1445
3940,189,2021-04-08 00:00:00,221,189,세종특별자치시,4161,378
216818,7609,2021-04-08 00:00:00,7293,1289,경기도,224111,8898
35952,1178,2021-04-08 00:00:00,2334,0,강원도,38286,1178
36525,197,2021-04-08 00:00:00,1417,704,충청북도,37942,901
48127,1239,2021-04-08 00:00:00,2346,98,충청남도,50473,1337
52447,190,2021-04-08 00:00:00,2521,363,전라북도,54968,553
54110,510,2021-04-08 00:00:00,2417,55,전라남도,56527,565
53687,972,2021-04-08 00:00:00,1376,455,경상북도,55063,1427
77575,1007,2021-04-08 00:00:00,2586,133,경상남도,80161,1140
12971,657,2021-04-08 00:00:00,739,569,제주특별자치도,13710,1226
1077067,42646,2021-04-09 00:00:00,36599,9490,전국,1113666,52136
166752,12397,2021-04-09 00:00:00,4627,756,서울특별시,171379,13153
84006,2388,2021-04-09 00:00:00,1927,929,부산광역시,85933,3317
47018,1387,2021-04-09 00:00:00,1805,679,대구광역시,48823,2066
61499,5082,2021-04-09 00:00:00,1827,1515,인천광역시,63326,6597
31846,1406,2021-04-09 00:00:00,677,1053,대전광역시,32523,2459
43946,938,2021-04-09 00:00:00,1096,97,광주광역시,45042,1035
25600,1445,2021-04-09 00:00:00,751,664,울산광역시,26351,2109
4161,378,2021-04-09 00:00:00,210,196,세종특별자치시,4371,574
224839,8898,2021-04-09 00:00:00,7624,828,경기도,232463,9726
38365,1178,2021-04-09 00:00:00,2031,0,강원도,40396,1178
37967,901,2021-04-09 00:00:00,1911,901,충청북도,39878,1802
50552,1337,2021-04-09 00:00:00,2371,175,충청남도,52923,1512
54977,553,2021-04-09 00:00:00,1839,356,전라북도,56816,909
56562,565,2021-04-09 00:00:00,2491,182,전라남도,59053,747
55079,1427,2021-04-09 00:00:00,2724,354,경상북도,57803,1781
80188,1140,2021-04-09 00:00:00,1878,226,경상남도,82066,1366
13710,1226,2021-04-09 00:00:00,810,579,제주특별자치도,14520,1805
1114656,52144,2021-04-10 00:00:00,33404,7278,전국,1148060,59422
171498,13155,2021-04-10 00:00:00,4648,321,서울특별시,176146,13476
86024,3317,2021-04-10 00:00:00,1869,844,부산광역시,87893,4161
48844,2066,2021-04-10 00:00:00,1884,678,대구광역시,50728,2744
63360,6598,2021-04-10 00:00:00,1703,1496,인천광역시,65063,8094
45042,1035,2021-04-10 00:00:00,1192,101,광주광역시,46234,1136
32524,2460,2021-04-10 00:00:00,729,1056,대전광역시,33253,3516
26351,2110,2021-04-10 00:00:00,736,709,울산광역시,27087,2819
4371,574,2021-04-10 00:00:00,349,208,세종특별자치시,4720,782
232984,9728,2021-04-10 00:00:00,6689,44,경기도,239673,9772
40412,1178,2021-04-10 00:00:00,1483,0,강원도,41895,1178
39989,1802,2021-04-10 00:00:00,2012,732,충청북도,42001,2534
52965,1513,2021-04-10 00:00:00,1560,7,충청남도,54525,1520
56817,909,2021-04-10 00:00:00,1654,263,전라북도,58471,1172
59059,747,2021-04-10 00:00:00,2117,69,전라남도,61176,816
57821,1781,2021-04-10 00:00:00,2180,328,경상북도,60001,2109
82074,1366,2021-04-10 00:00:00,1783,222,경상남도,83857,1588
14521,1805,2021-04-10 00:00:00,816,200,제주특별자치도,15337,2005
1148240,59422,2021-04-11 00:00:00,8710,1088,전국,1156950,60510
176222,13476,2021-04-11 00:00:00,1104,0,서울특별시,177326,13476
50728,2744,2021-04-11 00:00:00,0,202,대구광역시,50728,2946
87897,4161,2021-04-11 00:00:00,0,0,부산광역시,87897,4161
65063,8094,2021-04-11 00:00:00,577,650,인천광역시,65640,8744
46234,1136,2021-04-11 00:00:00,479,0,광주광역시,46713,1136
33253,3516,2021-04-11 00:00:00,160,236,대전광역시,33413,3752
27087,2819,2021-04-11 00:00:00,176,0,울산광역시,27263,2819
4720,782,2021-04-11 00:00:00,135,0,세종특별자치시,4855,782
239714,9772,2021-04-11 00:00:00,3392,0,경기도,243106,9772
41895,1178,2021-04-11 00:00:00,448,0,강원도,42343,1178
42059,2534,2021-04-11 00:00:00,464,0,충청북도,42523,2534
54525,1520,2021-04-11 00:00:00,169,0,충청남도,54694,1520
58472,1172,2021-04-11 00:00:00,401,0,전라북도,58873,1172
61176,816,2021-04-11 00:00:00,0,0,전라남도,61176,816
60001,2109,2021-04-11 00:00:00,525,0,경상북도,60526,2109
83857,1588,2021-04-11 00:00:00,499,0,경상남도,84356,1588
15337,2005,2021-04-11 00:00:00,181,0,제주특별자치도,15518,2005
1156950,60511,2021-04-12 00:00:00,305,0,전국,1157255,60511
177326,13476,2021-04-12 00:00:00,0,0,서울특별시,177326,13476
87897,4161,2021-04-12 00:00:00,0,0,부산광역시,87897,4161
50728,2946,2021-04-12 00:00:00,0,0,대구광역시,50728,2946
65640,8744,2021-04-12 00:00:00,0,0,인천광역시,65640,8744
33413,3753,2021-04-12 00:00:00,0,0,대전광역시,33413,3753
46713,1136,2021-04-12 00:00:00,0,0,광주광역시,46713,1136
27263,2819,2021-04-12 00:00:00,0,0,울산광역시,27263,2819
4855,782,2021-04-12 00:00:00,0,0,세종특별자치시,4855,782
243106,9772,2021-04-12 00:00:00,203,0,경기도,243309,9772
42343,1178,2021-04-12 00:00:00,0,0,강원도,42343,1178
42523,2534,2021-04-12 00:00:00,0,0,충청북도,42523,2534
54694,1520,2021-04-12 00:00:00,0,0,충청남도,54694,1520
58873,1172,2021-04-12 00:00:00,102,0,전라북도,58975,1172
61176,816,2021-04-12 00:00:00,0,0,전라남도,61176,816
60526,2109,2021-04-12 00:00:00,0,0,경상북도,60526,2109
84356,1588,2021-04-12 00:00:00,0,0,경상남도,84356,1588
15518,2005,2021-04-12 00:00:00,0,0,제주특별자치도,15518,2005
1157557,60532,2021-04-13 00:00:00,37785,25,전국,1195342,60557
177381,13476,2021-04-13 00:00:00,5428,22,서울특별시,182809,13498
87900,4161,2021-04-13 00:00:00,2318,0,부산광역시,90218,4161
50728,2946,2021-04-13 00:00:00,2034,0,대구광역시,52762,2946
65698,8745,2021-04-13 00:00:00,2214,0,인천광역시,67912,8745
27264,2819,2021-04-13 00:00:00,584,0,울산광역시,27848,2819
46711,1136,2021-04-13 00:00:00,1550,0,광주광역시,48261,1136
33416,3753,2021-04-13 00:00:00,684,0,대전광역시,34100,3753
243385,9772,2021-04-13 00:00:00,7440,3,경기도,250825,9775
42343,1178,2021-04-13 00:00:00,1566,0,강원도,43909,1178
4854,783,2021-04-13 00:00:00,271,0,세종특별자치시,5125,783
42523,2534,2021-04-13 00:00:00,2168,0,충청북도,44691,2534
54693,1520,2021-04-13 00:00:00,1182,0,충청남도,55875,1520
58975,1172,2021-04-13 00:00:00,2466,0,전라북도,61441,1172
61196,816,2021-04-13 00:00:00,2034,0,전라남도,63230,816
60614,2128,2021-04-13 00:00:00,2563,0,경상북도,63177,2128
84359,1588,2021-04-13 00:00:00,2473,0,경상남도,86832,1588
15517,2005,2021-04-13 00:00:00,810,0,제주특별자치도,16327,2005
1195676,60564,2021-04-14 00:00:00,43390,3,전국,1239066,60567
182821,13498,2021-04-14 00:00:00,5825,2,서울특별시,188646,13500
90218,4161,2021-04-14 00:00:00,2892,0,부산광역시,93110,4161
52763,2946,2021-04-14 00:00:00,2100,0,대구광역시,54863,2946
67917,8745,2021-04-14 00:00:00,2472,0,인천광역시,70389,8745
48262,1136,2021-04-14 00:00:00,1740,0,광주광역시,50002,1136
34101,3753,2021-04-14 00:00:00,843,0,대전광역시,34944,3753
5125,783,2021-04-14 00:00:00,352,0,세종특별자치시,5477,783
251001,9775,2021-04-14 00:00:00,8933,1,경기도,259934,9776
27848,2819,2021-04-14 00:00:00,495,0,울산광역시,28343,2819
43922,1178,2021-04-14 00:00:00,2263,0,강원도,46185,1178
44765,2534,2021-04-14 00:00:00,2582,0,충청북도,47347,2534
55878,1520,2021-04-14 00:00:00,1316,0,충청남도,57194,1520
61441,1172,2021-04-14 00:00:00,2575,0,전라북도,64016,1172
63264,816,2021-04-14 00:00:00,2538,0,전라남도,65802,816
63181,2135,2021-04-14 00:00:00,3074,0,경상북도,66255,2135
86842,1588,2021-04-14 00:00:00,2410,0,경상남도,89252,1588
16327,2005,2021-04-14 00:00:00,980,0,제주특별자치도,17307,2005
1240389,60567,2021-04-15 00:00:00,45520,2,전국,1285909,60569
188794,13500,2021-04-15 00:00:00,6277,2,서울특별시,195071,13502
93111,4161,2021-04-15 00:00:00,2971,0,부산광역시,96082,4161
70613,8745,2021-04-15 00:00:00,2545,0,인천광역시,73158,8745
54937,2946,2021-04-15 00:00:00,1493,0,대구광역시,56430,2946
34955,3753,2021-04-15 00:00:00,757,0,대전광역시,35712,3753
28423,2819,2021-04-15 00:00:00,580,0,울산광역시,29003,2819
50010,1136,2021-04-15 00:00:00,1019,0,광주광역시,51029,1136
260373,9776,2021-04-15 00:00:00,10256,0,경기도,270629,9776
46223,1178,2021-04-15 00:00:00,2016,0,강원도,48239,1178
5477,783,2021-04-15 00:00:00,341,0,세종특별자치시,5818,783
47466,2534,2021-04-15 00:00:00,2769,0,충청북도,50235,2534
57194,1520,2021-04-15 00:00:00,1420,0,충청남도,58614,1520
64017,1172,2021-04-15 00:00:00,2730,0,전라북도,66747,1172
65871,816,2021-04-15 00:00:00,3387,0,전라남도,69258,816
66302,2135,2021-04-15 00:00:00,3420,0,경상북도,69722,2135
89315,1588,2021-04-15 00:00:00,2586,0,경상남도,91901,1588
17308,2005,2021-04-15 00:00:00,953,0,제주특별자치도,18261,2005
1286993,60569,2021-04-16 00:00:00,92660,2,전국,1379653,60571
195222,13502,2021-04-16 00:00:00,13522,0,서울특별시,208744,13502
96105,4161,2021-04-16 00:00:00,3491,0,부산광역시,99596,4161
56463,2946,2021-04-16 00:00:00,3205,0,대구광역시,59668,2946
73217,8745,2021-04-16 00:00:00,4132,0,인천광역시,77349,8745
35746,3753,2021-04-16 00:00:00,2425,0,대전광역시,38171,3753
51031,1136,2021-04-16 00:00:00,2416,0,광주광역시,53447,1136
29005,2819,2021-04-16 00:00:00,1050,2,울산광역시,30055,2821
270941,9776,2021-04-16 00:00:00,17781,0,경기도,288722,9776
5817,783,2021-04-16 00:00:00,588,0,세종특별자치시,6405,783
48296,1178,2021-04-16 00:00:00,4956,0,강원도,53252,1178
50336,2534,2021-04-16 00:00:00,4452,0,충청북도,54788,2534
58616,1520,2021-04-16 00:00:00,5350,0,충청남도,63966,1520
66901,1172,2021-04-16 00:00:00,4134,0,전라북도,71035,1172
69289,816,2021-04-16 00:00:00,7252,0,전라남도,76541,816
69818,2135,2021-04-16 00:00:00,7671,0,경상북도,77489,2135
91929,1588,2021-04-16 00:00:00,9186,0,경상남도,101115,1588
18261,2005,2021-04-16 00:00:00,1049,0,제주특별자치도,19310,2005
1380579,60571,2021-04-17 00:00:00,102390,6,전국,1482969,60577
208840,13502,2021-04-17 00:00:00,15707,5,서울특별시,224547,13507
99608,4161,2021-04-17 00:00:00,4465,0,부산광역시,104073,4161
59707,2946,2021-04-17 00:00:00,3708,0,대구광역시,63415,2946
53448,1136,2021-04-17 00:00:00,1844,0,광주광역시,55292,1136
77487,8745,2021-04-17 00:00:00,4780,0,인천광역시,82267,8745
6404,783,2021-04-17 00:00:00,912,0,세종특별자치시,7316,783
38178,3753,2021-04-17 00:00:00,2896,0,대전광역시,41074,3753
289027,9776,2021-04-17 00:00:00,20255,1,경기도,309282,9777
30066,2821,2021-04-17 00:00:00,1231,0,울산광역시,31297,2821
53282,1178,2021-04-17 00:00:00,4645,0,강원도,57927,1178
54919,2534,2021-04-17 00:00:00,4222,0,충청북도,59141,2534
63979,1520,2021-04-17 00:00:00,5390,0,충청남도,69369,1520
71035,1172,2021-04-17 00:00:00,4371,0,전라북도,75406,1172
76585,816,2021-04-17 00:00:00,7986,0,전라남도,84571,816
77506,2135,2021-04-17 00:00:00,9472,0,경상북도,86978,2135
101199,1588,2021-04-17 00:00:00,9168,0,경상남도,110367,1588
19309,2005,2021-04-17 00:00:00,1338,0,제주특별자치도,20647,2005
1483338,60585,2021-04-18 00:00:00,29165,0,전국,1512503,60585
224643,13507,2021-04-18 00:00:00,2259,0,서울특별시,226902,13507
104075,4161,2021-04-18 00:00:00,489,0,부산광역시,104564,4161
63432,2946,2021-04-18 00:00:00,1158,0,대구광역시,64590,2946
82271,8745,2021-04-18 00:00:00,1356,0,인천광역시,83627,8745
55292,1136,2021-04-18 00:00:00,313,0,광주광역시,55605,1136
31297,2821,2021-04-18 00:00:00,100,0,울산광역시,31397,2821
41134,3753,2021-04-18 00:00:00,214,0,대전광역시,41348,3753
7316,783,2021-04-18 00:00:00,256,0,세종특별자치시,7572,783
309402,9785,2021-04-18 00:00:00,11704,0,경기도,321106,9785
57947,1178,2021-04-18 00:00:00,301,0,강원도,58248,1178
59141,2534,2021-04-18 00:00:00,592,0,충청북도,59733,2534
69371,1520,2021-04-18 00:00:00,2254,0,충청남도,71625,1520
75406,1172,2021-04-18 00:00:00,458,0,전라북도,75864,1172
84597,816,2021-04-18 00:00:00,904,0,전라남도,85501,816
86978,2135,2021-04-18 00:00:00,4622,0,경상북도,91600,2135
110389,1588,2021-04-18 00:00:00,2064,0,경상남도,112453,1588
20647,2005,2021-04-18 00:00:00,121,0,제주특별자치도,20768,2005
1512531,60585,2021-04-19 00:00:00,4859,0,전국,1517390,60585
226902,13507,2021-04-19 00:00:00,0,0,서울특별시,226902,13507
104564,4161,2021-04-19 00:00:00,0,0,부산광역시,104564,4161
64590,2946,2021-04-19 00:00:00,1040,0,대구광역시,65630,2946
83627,8745,2021-04-19 00:00:00,0,0,인천광역시,83627,8745
31397,2821,2021-04-19 00:00:00,0,0,울산광역시,31397,2821
55605,1136,2021-04-19 00:00:00,0,0,광주광역시,55605,1136
41348,3753,2021-04-19 00:00:00,0,0,대전광역시,41348,3753
7572,783,2021-04-19 00:00:00,0,0,세종특별자치시,7572,783
321111,9785,2021-04-19 00:00:00,1303,0,경기도,322414,9785
58248,1178,2021-04-19 00:00:00,0,0,강원도,58248,1178
59733,2534,2021-04-19 00:00:00,0,0,충청북도,59733,2534
71626,1520,2021-04-19 00:00:00,786,0,충청남도,72412,1520
75864,1172,2021-04-19 00:00:00,0,0,전라북도,75864,1172
85503,816,2021-04-19 00:00:00,0,0,전라남도,85503,816
91620,2135,2021-04-19 00:00:00,1730,0,경상북도,93350,2135
112453,1588,2021-04-19 00:00:00,0,0,경상남도,112453,1588
20768,2005,2021-04-19 00:00:00,0,0,제주특별자치도,20768,2005
1518256,60585,2021-04-20 00:00:00,121234,1,전국,1639490,60586
227123,13507,2021-04-20 00:00:00,21362,1,서울특별시,248485,13508
104686,4161,2021-04-20 00:00:00,5286,0,부산광역시,109972,4161
65651,2946,2021-04-20 00:00:00,4354,0,대구광역시,70005,2946
83661,8745,2021-04-20 00:00:00,4928,0,인천광역시,88589,8745
31398,2821,2021-04-20 00:00:00,1683,0,울산광역시,33081,2821
55610,1136,2021-04-20 00:00:00,2611,0,광주광역시,58221,1136
41382,3753,2021-04-20 00:00:00,3806,0,대전광역시,45188,3753
322600,9785,2021-04-20 00:00:00,23590,0,경기도,346190,9785
7572,783,2021-04-20 00:00:00,702,0,세종특별자치시,8274,783
58375,1178,2021-04-20 00:00:00,4963,0,강원도,63338,1178
59762,2534,2021-04-20 00:00:00,4038,0,충청북도,63800,2534
72461,1520,2021-04-20 00:00:00,8220,0,충청남도,80681,1520
75862,1172,2021-04-20 00:00:00,5052,0,전라북도,80914,1172
85507,816,2021-04-20 00:00:00,8217,0,전라남도,93724,816
93380,2135,2021-04-20 00:00:00,10554,0,경상북도,103934,2135
112456,1588,2021-04-20 00:00:00,10715,0,경상남도,123171,1588
20770,2005,2021-04-20 00:00:00,1153,0,제주특별자치도,21923,2005
1641179,60586,2021-04-21 00:00:00,130228,11,전국,1771407,60597
248994,13508,2021-04-21 00:00:00,22033,10,서울특별시,271027,13518
110007,4161,2021-04-21 00:00:00,5615,0,부산광역시,115622,4161
88631,8745,2021-04-21 00:00:00,5173,0,인천광역시,93804,8745
70050,2946,2021-04-21 00:00:00,4624,0,대구광역시,74674,2946
45300,3753,2021-04-21 00:00:00,3657,0,대전광역시,48957,3753
33092,2821,2021-04-21 00:00:00,1539,0,울산광역시,34631,2821
58265,1136,2021-04-21 00:00:00,4456,0,광주광역시,62721,1136
346523,9785,2021-04-21 00:00:00,26605,1,경기도,373128,9786
63384,1178,2021-04-21 00:00:00,5238,0,강원도,68622,1178
8273,783,2021-04-21 00:00:00,722,0,세종특별자치시,8995,783
63835,2534,2021-04-21 00:00:00,5009,0,충청북도,68844,2534
80787,1520,2021-04-21 00:00:00,8461,0,충청남도,89248,1520
80934,1172,2021-04-21 00:00:00,5602,0,전라북도,86536,1172
93817,816,2021-04-21 00:00:00,8031,0,전라남도,101848,816
104059,2135,2021-04-21 00:00:00,11106,0,경상북도,115165,2135
123254,1588,2021-04-21 00:00:00,10960,0,경상남도,134214,1588
21974,2005,2021-04-21 00:00:00,1397,0,제주특별자치도,23371,2005
1772539,60597,2021-04-22 00:00:00,131228,25,전국,1903767,60622
271322,13518,2021-04-22 00:00:00,23233,25,서울특별시,294555,13543
115675,4161,2021-04-22 00:00:00,6027,0,부산광역시,121702,4161
74759,2946,2021-04-22 00:00:00,3962,0,대구광역시,78721,2946
93867,8745,2021-04-22 00:00:00,5176,0,인천광역시,99043,8745
62730,1136,2021-04-22 00:00:00,4209,0,광주광역시,66939,1136
8994,783,2021-04-22 00:00:00,749,0,세종특별자치시,9743,783
34631,2821,2021-04-22 00:00:00,2096,0,울산광역시,36727,2821
48968,3753,2021-04-22 00:00:00,3295,0,대전광역시,52263,3753
373395,9786,2021-04-22 00:00:00,26233,0,경기도,399628,9786
68634,1178,2021-04-22 00:00:00,4812,0,강원도,73446,1178
68866,2534,2021-04-22 00:00:00,5103,0,충청북도,73969,2534
89332,1520,2021-04-22 00:00:00,9318,0,충청남도,98650,1520
86546,1172,2021-04-22 00:00:00,5574,0,전라북도,92120,1172
101870,816,2021-04-22 00:00:00,8724,0,전라남도,110594,816
115241,2135,2021-04-22 00:00:00,10631,0,경상북도,125872,2135
134278,1588,2021-04-22 00:00:00,10444,0,경상남도,144722,1588
23376,2005,2021-04-22 00:00:00,1642,0,제주특별자치도,25018,2005
55,0,2021-04-22 00:00:00,0,0,기타,55,0
1904934,60623,2021-04-23 00:00:00,130615,18528,전국,2035549,79151
294885,13543,2021-04-23 00:00:00,22501,2358,서울특별시,317386,15901
121719,4161,2021-04-23 00:00:00,5547,799,부산광역시,127266,4960
99139,8745,2021-04-23 00:00:00,4917,994,인천광역시,104056,9739
78746,2946,2021-04-23 00:00:00,5386,500,대구광역시,84132,3446
52274,3753,2021-04-23 00:00:00,3658,283,대전광역시,55932,4036
36818,2822,2021-04-23 00:00:00,1930,525,울산광역시,38748,3347
66946,1136,2021-04-23 00:00:00,3678,857,광주광역시,70624,1993
399890,9786,2021-04-23 00:00:00,27774,2350,경기도,427664,12136
73448,1178,2021-04-23 00:00:00,4131,1809,강원도,77579,2987
9744,783,2021-04-23 00:00:00,478,213,세종특별자치시,10222,996
74000,2534,2021-04-23 00:00:00,4114,1521,충청북도,78114,4055
98794,1520,2021-04-23 00:00:00,7373,1208,충청남도,106167,2728
92119,1172,2021-04-23 00:00:00,7488,1206,전라북도,99607,2378
110636,816,2021-04-23 00:00:00,9589,1245,전라남도,120225,2061
125936,2135,2021-04-23 00:00:00,8727,399,경상북도,134663,2534
144746,1588,2021-04-23 00:00:00,11745,1709,경상남도,156491,3297
25039,2005,2021-04-23 00:00:00,1579,552,제주특별자치도,26618,2557
55,0,2021-04-23 00:00:00,0,0,기타,55,0
2036911,79154,2021-04-24 00:00:00,158581,19613,전국,2195492,98767
317795,15901,2021-04-24 00:00:00,27074,2479,서울특별시,344869,18380
127281,4960,2021-04-24 00:00:00,7832,888,부산광역시,135113,5848
84187,3446,2021-04-24 00:00:00,6800,497,대구광역시,90987,3943
104122,9739,2021-04-24 00:00:00,6559,926,인천광역시,110681,10665
70626,1993,2021-04-24 00:00:00,4854,861,광주광역시,75480,2854
38745,3347,2021-04-24 00:00:00,2196,519,울산광역시,40941,3866
55944,4036,2021-04-24 00:00:00,4684,284,대전광역시,60628,4320
10224,996,2021-04-24 00:00:00,752,166,세종특별자치시,10976,1162
428000,12137,2021-04-24 00:00:00,33828,2418,경기도,461828,14555
77671,2987,2021-04-24 00:00:00,4840,1901,강원도,82511,4888
78178,4055,2021-04-24 00:00:00,5271,1495,충청북도,83449,5550
106399,2728,2021-04-24 00:00:00,6794,1354,충청남도,113193,4082
99606,2378,2021-04-24 00:00:00,8209,1572,전라북도,107815,3950
120241,2061,2021-04-24 00:00:00,10541,1534,전라남도,130782,3595
134666,2534,2021-04-24 00:00:00,11790,399,경상북도,146456,2933
156549,3299,2021-04-24 00:00:00,14841,1812,경상남도,171390,5111
26622,2557,2021-04-24 00:00:00,1716,508,제주특별자치도,28338,3065
55,0,2021-04-24 00:00:00,0,0,기타,55,0
2196295,98769,2021-04-25 00:00:00,64344,5769,전국,2260639,104538
345158,18380,2021-04-25 00:00:00,10195,119,서울특별시,355353,18499
135163,5848,2021-04-25 00:00:00,3576,0,부산광역시,138739,5848
91029,3943,2021-04-25 00:00:00,3569,0,대구광역시,94598,3943
60632,4320,2021-04-25 00:00:00,1078,1,대전광역시,61710,4321
110753,10665,2021-04-25 00:00:00,2569,472,인천광역시,113322,11137
75483,2854,2021-04-25 00:00:00,1374,128,광주광역시,76857,2982
40942,3866,2021-04-25 00:00:00,482,126,울산광역시,41424,3992
461888,14555,2021-04-25 00:00:00,19739,2167,경기도,481627,16722
82520,4889,2021-04-25 00:00:00,1065,533,강원도,83585,5422
10976,1162,2021-04-25 00:00:00,308,62,세종특별자치시,11284,1224
83458,5550,2021-04-25 00:00:00,2103,348,충청북도,85561,5898
113206,4082,2021-04-25 00:00:00,3631,494,충청남도,116837,4576
107820,3951,2021-04-25 00:00:00,2608,713,전라북도,110428,4664
130820,3595,2021-04-25 00:00:00,2452,246,전라남도,133272,3841
146457,2933,2021-04-25 00:00:00,4163,0,경상북도,150620,2933
171423,5111,2021-04-25 00:00:00,4984,345,경상남도,176407,5456
28338,3065,2021-04-25 00:00:00,448,15,제주특별자치도,28786,3080
229,0,2021-04-25 00:00:00,0,0,기타,229,0
2260748,104538,2021-04-26 00:00:00,6140,367,전국,2266888,104905
355353,18499,2021-04-26 00:00:00,200,0,서울특별시,355553,18499
138739,5848,2021-04-26 00:00:00,3,0,부산광역시,138742,5848
94598,3943,2021-04-26 00:00:00,735,111,대구광역시,95333,4054
113322,11137,2021-04-26 00:00:00,33,0,인천광역시,113355,11137
76857,2982,2021-04-26 00:00:00,0,0,광주광역시,76857,2982
41424,3992,2021-04-26 00:00:00,113,0,울산광역시,41537,3992
61709,4321,2021-04-26 00:00:00,44,0,대전광역시,61753,4321
11284,1224,2021-04-26 00:00:00,16,0,세종특별자치시,11300,1224
481717,16722,2021-04-26 00:00:00,2292,0,경기도,484009,16722
83585,5422,2021-04-26 00:00:00,13,0,강원도,83598,5422
85561,5898,2021-04-26 00:00:00,51,63,충청북도,85612,5961
116839,4576,2021-04-26 00:00:00,461,0,충청남도,117300,4576
110428,4664,2021-04-26 00:00:00,835,193,전라북도,111263,4857
133270,3841,2021-04-26 00:00:00,3,0,전라남도,133273,3841
150620,2933,2021-04-26 00:00:00,1302,0,경상북도,151922,2933
176427,5456,2021-04-26 00:00:00,6,0,경상남도,176433,5456
28786,3080,2021-04-26 00:00:00,33,0,제주특별자치도,28819,3080
229,0,2021-04-26 00:00:00,0,0,기타,229,0
2268038,104905,2021-04-27 00:00:00,141937,21598,전국,2409975,126503
355797,18499,2021-04-27 00:00:00,23323,3411,서울특별시,379120,21910
138847,5848,2021-04-27 00:00:00,7696,898,부산광역시,146543,6746
95366,4054,2021-04-27 00:00:00,5905,514,대구광역시,101271,4568
113378,11137,2021-04-27 00:00:00,6286,1005,인천광역시,119664,12142
76862,2982,2021-04-27 00:00:00,3931,933,광주광역시,80793,3915
41539,3992,2021-04-27 00:00:00,2084,965,울산광역시,43623,4957
61825,4321,2021-04-27 00:00:00,4176,492,대전광역시,66001,4813
11300,1224,2021-04-27 00:00:00,707,200,세종특별자치시,12007,1424
484528,16722,2021-04-27 00:00:00,30764,2715,경기도,515292,19437
83616,5422,2021-04-27 00:00:00,4402,1640,강원도,88018,7062
85656,5961,2021-04-27 00:00:00,5282,1492,충청북도,90938,7453
117453,4576,2021-04-27 00:00:00,5191,1521,충청남도,122644,6097
111286,4857,2021-04-27 00:00:00,11439,1566,전라북도,122725,6423
133299,3841,2021-04-27 00:00:00,9208,1509,전라남도,142507,5350
151956,2933,2021-04-27 00:00:00,10127,393,경상북도,162083,3326
176496,5456,2021-04-27 00:00:00,9631,1776,경상남도,186127,7232
28834,3080,2021-04-27 00:00:00,1785,568,제주특별자치도,30619,3648
2410975,126506,2021-04-28 00:00:00,175794,21776,전국,2586769,148282
379424,21910,2021-04-28 00:00:00,26585,3725,서울특별시,406009,25635
146554,6747,2021-04-28 00:00:00,11312,920,부산광역시,157866,7667
101368,4568,2021-04-28 00:00:00,7287,533,대구광역시,108655,5101
80817,3915,2021-04-28 00:00:00,4912,939,광주광역시,85729,4854
119685,12143,2021-04-28 00:00:00,7280,1022,인천광역시,126965,13165
43624,4957,2021-04-28 00:00:00,2746,1044,울산광역시,46370,6001
12008,1424,2021-04-28 00:00:00,756,203,세종특별자치시,12764,1627
66001,4813,2021-04-28 00:00:00,5661,445,대전광역시,71662,5258
515430,19438,2021-04-28 00:00:00,37388,2815,경기도,552818,22253
91115,7453,2021-04-28 00:00:00,6687,1441,충청북도,97802,8894
88030,7062,2021-04-28 00:00:00,7021,1656,강원도,95051,8718
122761,6097,2021-04-28 00:00:00,6581,1424,충청남도,129342,7521
122727,6423,2021-04-28 00:00:00,13354,1432,전라북도,136081,7855
142528,5350,2021-04-28 00:00:00,12178,1522,전라남도,154706,6872
162139,3326,2021-04-28 00:00:00,9699,435,경상북도,171838,3761
186143,7232,2021-04-28 00:00:00,14310,1685,경상남도,200453,8917
30621,3648,2021-04-28 00:00:00,2037,535,제주특별자치도,32658,4183
2588065,148286,2021-04-29 00:00:00,220729,20435,전국,2808794,168721
406474,25637,2021-04-29 00:00:00,31795,2062,서울특별시,438269,27699
157946,7667,2021-04-29 00:00:00,16997,925,부산광역시,174943,8592
108669,5101,2021-04-29 00:00:00,9125,536,대구광역시,117794,5637
126980,13165,2021-04-29 00:00:00,11066,1023,인천광역시,138046,14188
46400,6001,2021-04-29 00:00:00,2913,1518,울산광역시,49313,7519
85728,4854,2021-04-29 00:00:00,5689,833,광주광역시,91417,5687
71664,5258,2021-04-29 00:00:00,6619,456,대전광역시,78283,5714
553250,22253,2021-04-29 00:00:00,48548,2946,경기도,601798,25199
12763,1627,2021-04-29 00:00:00,1027,175,세종특별자치시,13790,1802
95161,8718,2021-04-29 00:00:00,7839,1693,강원도,103000,10411
97816,8894,2021-04-29 00:00:00,9329,815,충청북도,107145,9709
129407,7521,2021-04-29 00:00:00,11211,1578,충청남도,140618,9099
136080,7856,2021-04-29 00:00:00,15483,1592,전라북도,151563,9448
154702,6872,2021-04-29 00:00:00,12321,1462,전라남도,167023,8334
171845,3762,2021-04-29 00:00:00,13248,399,경상북도,185093,4161
200464,8917,2021-04-29 00:00:00,15194,1893,경상남도,215658,10810
32716,4183,2021-04-29 00:00:00,2325,529,제주특별자치도,35041,4712
2814037,168724,2021-04-30 00:00:00,241967,30010,전국,3056004,198734
438892,27699,2021-04-30 00:00:00,33484,3921,서울특별시,472376,31620
175130,8592,2021-04-30 00:00:00,17482,1738,부산광역시,192612,10330
118177,5637,2021-04-30 00:00:00,10926,1467,대구광역시,129103,7104
138138,14188,2021-04-30 00:00:00,12994,1546,인천광역시,151132,15734
78531,5714,2021-04-30 00:00:00,7278,418,대전광역시,85809,6132
91528,5687,2021-04-30 00:00:00,6276,1074,광주광역시,97804,6761
49318,7521,2021-04-30 00:00:00,3714,1300,울산광역시,53032,8821
13816,1802,2021-04-30 00:00:00,867,206,세종특별자치시,14683,2008
603522,25199,2021-04-30 00:00:00,56575,4824,경기도,660097,30023
103738,10411,2021-04-30 00:00:00,10865,1803,강원도,114603,12214
107270,9709,2021-04-30 00:00:00,9676,1538,충청북도,116946,11247
140910,9099,2021-04-30 00:00:00,11645,2066,충청남도,152555,11165
151629,9448,2021-04-30 00:00:00,13527,1587,전라북도,165156,11035
167180,8335,2021-04-30 00:00:00,15263,2119,전라남도,182443,10454
185328,4161,2021-04-30 00:00:00,15835,1969,경상북도,201163,6130
215871,10810,2021-04-30 00:00:00,13095,1738,경상남도,228966,12548
35059,4712,2021-04-30 00:00:00,2465,696,제주특별자치도,37524,5408
3066985,198744,2021-05-01 00:00:00,259018,29655,전국,3326003,228399
473315,31622,2021-05-01 00:00:00,37847,4278,서울특별시,511162,35900
193025,10330,2021-05-01 00:00:00,20355,1779,부산광역시,213380,12109
129775,7104,2021-05-01 00:00:00,11692,1604,대구광역시,141467,8708
85958,6132,2021-05-01 00:00:00,7371,517,대전광역시,93329,6649
151576,15734,2021-05-01 00:00:00,14515,1601,인천광역시,166091,17335
98062,6761,2021-05-01 00:00:00,6763,1181,광주광역시,104825,7942
53057,8824,2021-05-01 00:00:00,3809,1144,울산광역시,56866,9968
663849,30025,2021-05-01 00:00:00,61313,5026,경기도,725162,35051
115981,12214,2021-05-01 00:00:00,11443,1388,강원도,127424,13602
14738,2008,2021-05-01 00:00:00,1037,346,세종특별자치시,15775,2354
117511,11247,2021-05-01 00:00:00,9109,1897,충청북도,126620,13144
153075,11166,2021-05-01 00:00:00,13324,1384,충청남도,166399,12550
165451,11035,2021-05-01 00:00:00,11190,1442,전라북도,176641,12477
182567,10454,2021-05-01 00:00:00,15580,1856,전라남도,198147,12310
201902,6130,2021-05-01 00:00:00,16971,1795,경상북도,218873,7925
229575,12550,2021-05-01 00:00:00,13631,1716,경상남도,243206,14266
37568,5408,2021-05-01 00:00:00,3068,701,제주특별자치도,40636,6109
3355935,228476,2021-05-02 00:00:00,39169,7712,전국,3395104,236188
513190,35900,2021-05-02 00:00:00,6655,691,서울특별시,519845,36591
214249,12109,2021-05-02 00:00:00,2048,1,부산광역시,216297,12110
142157,8708,2021-05-02 00:00:00,2336,1,대구광역시,144493,8709
166953,17335,2021-05-02 00:00:00,1486,570,인천광역시,168439,17905
94327,6649,2021-05-02 00:00:00,934,152,대전광역시,95261,6801
56944,9968,2021-05-02 00:00:00,486,118,울산광역시,57430,10086
105264,7942,2021-05-02 00:00:00,1435,463,광주광역시,106699,8405
16098,2354,2021-05-02 00:00:00,178,135,세종특별자치시,16276,2489
736939,35127,2021-05-02 00:00:00,12148,3167,경기도,749087,38294
127464,13144,2021-05-02 00:00:00,1320,371,충청북도,128784,13515
168129,12550,2021-05-02 00:00:00,1649,146,충청남도,169778,12696
132916,13602,2021-05-02 00:00:00,1041,444,강원도,133957,14046
177137,12478,2021-05-02 00:00:00,1592,358,전라북도,178729,12836
198858,12310,2021-05-02 00:00:00,1500,0,전라남도,200358,12310
219581,7925,2021-05-02 00:00:00,1253,500,경상북도,220834,8425
245000,14266,2021-05-02 00:00:00,2589,451,경상남도,247589,14717
40729,6109,2021-05-02 00:00:00,519,144,제주특별자치도,41248,6253
3395303,236188,2021-05-03 00:00:00,1561,301,전국,3396864,236489
520118,36591,2021-05-03 00:00:00,82,0,서울특별시,520200,36591
216352,12110,2021-05-03 00:00:00,0,0,부산광역시,216352,12110
144692,8709,2021-05-03 00:00:00,655,0,대구광역시,145347,8709
168436,17905,2021-05-03 00:00:00,0,0,인천광역시,168436,17905
106782,8405,2021-05-03 00:00:00,615,0,광주광역시,107397,8405
16458,2489,2021-05-03 00:00:00,0,0,세종특별자치시,16458,2489
95292,6801,2021-05-03 00:00:00,9,0,대전광역시,95301,6801
746309,38294,2021-05-03 00:00:00,116,200,경기도,746425,38494
57413,10086,2021-05-03 00:00:00,56,0,울산광역시,57469,10086
134616,14046,2021-05-03 00:00:00,11,0,강원도,134627,14046
128940,13515,2021-05-03 00:00:00,2,0,충청북도,128942,13515
170535,12696,2021-05-03 00:00:00,0,0,충청남도,170535,12696
178778,12836,2021-05-03 00:00:00,13,101,전라북도,178791,12937
200486,12310,2021-05-03 00:00:00,0,0,전라남도,200486,12310
220957,8425,2021-05-03 00:00:00,1,0,경상북도,220958,8425
247975,14717,2021-05-03 00:00:00,0,0,경상남도,247975,14717
41164,6253,2021-05-03 00:00:00,1,0,제주특별자치도,41165,6253
3399988,236494,2021-05-04 00:00:00,66920,30538,전국,3466908,267032
520609,36591,2021-05-04 00:00:00,19795,5033,서울특별시,540404,41624
216574,12110,2021-05-04 00:00:00,3317,2075,부산광역시,219891,14185
145365,8709,2021-05-04 00:00:00,2816,1765,대구광역시,148181,10474
107397,8405,2021-05-04 00:00:00,1993,1284,광주광역시,109390,9689
168514,17905,2021-05-04 00:00:00,3487,1810,인천광역시,172001,19715
57475,10086,2021-05-04 00:00:00,1513,502,울산광역시,58988,10588
95335,6801,2021-05-04 00:00:00,2789,510,대전광역시,98124,7311
747608,38495,2021-05-04 00:00:00,9743,4987,경기도,757351,43482
16470,2489,2021-05-04 00:00:00,393,242,세종특별자치시,16863,2731
134692,14046,2021-05-04 00:00:00,1737,1369,강원도,136429,15415
129069,13515,2021-05-04 00:00:00,1248,1713,충청북도,130317,15228
170587,12697,2021-05-04 00:00:00,1962,816,충청남도,172549,13513
178815,12938,2021-05-04 00:00:00,1816,2144,전라북도,180631,15082
200540,12311,2021-05-04 00:00:00,5698,1755,전라남도,206238,14066
221023,8425,2021-05-04 00:00:00,4719,1941,경상북도,225742,10366
248668,14718,2021-05-04 00:00:00,2410,1831,경상남도,251078,16549
41247,6253,2021-05-04 00:00:00,1484,761,제주특별자치도,42731,7014
3467507,267033,2021-05-05 00:00:00,62507,31159,전국,3530014,298192
540663,41625,2021-05-05 00:00:00,18942,4665,서울특별시,559605,46290
219960,14185,2021-05-05 00:00:00,2997,2300,부산광역시,222957,16485
148186,10474,2021-05-05 00:00:00,2055,1673,대구광역시,150241,12147
109390,9689,2021-05-05 00:00:00,2335,1334,광주광역시,111725,11023
172015,19715,2021-05-05 00:00:00,3113,1841,인천광역시,175128,21556
98131,7311,2021-05-05 00:00:00,2878,493,대전광역시,101009,7804
59005,10588,2021-05-05 00:00:00,679,348,울산광역시,59684,10936
16863,2731,2021-05-05 00:00:00,353,316,세종특별자치시,17216,3047
757560,43482,2021-05-05 00:00:00,10405,5339,경기도,767965,48821
136436,15415,2021-05-05 00:00:00,1322,1636,강원도,137758,17051
130328,15228,2021-05-05 00:00:00,1253,1791,충청북도,131581,17019
172547,13513,2021-05-05 00:00:00,1670,773,충청남도,174217,14286
180626,15082,2021-05-05 00:00:00,1576,2153,전라북도,182202,17235
206228,14066,2021-05-05 00:00:00,5954,1760,전라남도,212182,15826
225758,10366,2021-05-05 00:00:00,3533,2543,경상북도,229291,12909
251077,16549,2021-05-05 00:00:00,2602,1439,경상남도,253679,17988
42734,7014,2021-05-05 00:00:00,840,755,제주특별자치도,43574,7769
3555071,298195,2021-05-06 00:00:00,5253,25310,전국,3560324,323505
561256,46290,2021-05-06 00:00:00,1788,1650,서울특별시,563044,47940
223710,16485,2021-05-06 00:00:00,287,1764,부산광역시,223997,18249
176046,21556,2021-05-06 00:00:00,6,1827,인천광역시,176052,23383
151187,12147,2021-05-06 00:00:00,726,1104,대구광역시,151913,13251
59756,10936,2021-05-06 00:00:00,24,0,울산광역시,59780,10936
112032,11023,2021-05-06 00:00:00,40,654,광주광역시,112072,11677
17434,3047,2021-05-06 00:00:00,245,238,세종특별자치시,17679,3285
101620,7804,2021-05-06 00:00:00,10,0,대전광역시,101630,7804
777728,48824,2021-05-06 00:00:00,1574,5682,경기도,779302,54506
142341,17051,2021-05-06 00:00:00,37,1369,강원도,142378,18420
132506,17019,2021-05-06 00:00:00,9,1544,충청북도,132515,18563
175178,14286,2021-05-06 00:00:00,6,769,충청남도,175184,15055
182580,17235,2021-05-06 00:00:00,121,2167,전라북도,182701,19402
212396,15826,2021-05-06 00:00:00,256,1868,전라남도,212652,17694
230161,12909,2021-05-06 00:00:00,6,2426,경상북도,230167,15335
255489,17988,2021-05-06 00:00:00,33,1493,경상남도,255522,19481
43651,7769,2021-05-06 00:00:00,85,755,제주특별자치도,43736,8524
3566651,323699,2021-05-07 00:00:00,41965,73491,전국,3608616,397190
563562,47992,2021-05-07 00:00:00,11021,11715,서울특별시,574583,59707
224181,18265,2021-05-07 00:00:00,2580,2683,부산광역시,226761,20948
151970,13254,2021-05-07 00:00:00,2064,2375,대구광역시,154034,15629
176244,23390,2021-05-07 00:00:00,2139,2850,인천광역시,178383,26240
112103,11677,2021-05-07 00:00:00,1807,1792,광주광역시,113910,13469
101937,7809,2021-05-07 00:00:00,1000,1980,대전광역시,102937,9789
59790,10937,2021-05-07 00:00:00,795,804,울산광역시,60585,11741
17767,3285,2021-05-07 00:00:00,275,482,세종특별자치시,18042,3767
781835,54545,2021-05-07 00:00:00,7110,12319,경기도,788945,66864
142829,18421,2021-05-07 00:00:00,1640,3923,강원도,144469,22344
132705,18564,2021-05-07 00:00:00,1306,3171,충청북도,134011,21735
175519,15076,2021-05-07 00:00:00,1142,4680,충청남도,176661,19756
182744,19403,2021-05-07 00:00:00,1725,3140,전라북도,184469,22543
212765,17704,2021-05-07 00:00:00,2495,6559,전라남도,215260,24263
230250,15341,2021-05-07 00:00:00,2319,6534,경상북도,232569,21875
256688,19512,2021-05-07 00:00:00,1640,7730,경상남도,258328,27242
43762,8524,2021-05-07 00:00:00,907,754,제주특별자치도,44669,9278
3623605,397204,2021-05-08 00:00:00,38982,76790,전국,3662587,473994
575713,59728,2021-05-08 00:00:00,11230,11486,서울특별시,586943,71214
227306,20949,2021-05-08 00:00:00,2449,2642,부산광역시,229755,23591
154493,15630,2021-05-08 00:00:00,1894,2487,대구광역시,156387,18117
114101,13470,2021-05-08 00:00:00,1837,1181,광주광역시,115938,14651
178945,26248,2021-05-08 00:00:00,1929,2944,인천광역시,180874,29192
103428,9791,2021-05-08 00:00:00,757,2119,대전광역시,104185,11910
18179,3767,2021-05-08 00:00:00,149,675,세종특별자치시,18328,4442
60607,11742,2021-05-08 00:00:00,958,928,울산광역시,61565,12670
794444,66804,2021-05-08 00:00:00,6315,15032,경기도,800759,81836
146445,22353,2021-05-08 00:00:00,1095,3688,강원도,147540,26041
134637,21740,2021-05-08 00:00:00,931,3114,충청북도,135568,24854
177511,19764,2021-05-08 00:00:00,1119,4188,충청남도,178630,23952
184832,22547,2021-05-08 00:00:00,1230,3163,전라북도,186062,25710
215437,24265,2021-05-08 00:00:00,2989,6756,전라남도,218426,31021
232959,21878,2021-05-08 00:00:00,1804,7848,경상북도,234763,29726
259793,27249,2021-05-08 00:00:00,1467,7736,경상남도,261260,34985
44775,9279,2021-05-08 00:00:00,829,803,제주특별자치도,45604,10082
3662751,473993,2021-05-09 00:00:00,11931,27546,전국,3674682,501539
586991,71213,2021-05-09 00:00:00,4044,2082,서울특별시,591035,73295
229786,23591,2021-05-09 00:00:00,800,404,부산광역시,230586,23995
156391,18117,2021-05-09 00:00:00,571,1079,대구광역시,156962,19196
180886,29192,2021-05-09 00:00:00,625,1359,인천광역시,181511,30551
104185,11910,2021-05-09 00:00:00,259,209,대전광역시,104444,12119
115937,14651,2021-05-09 00:00:00,571,97,광주광역시,116508,14748
61581,12670,2021-05-09 00:00:00,171,90,울산광역시,61752,12760
18328,4442,2021-05-09 00:00:00,120,255,세종특별자치시,18448,4697
147544,26041,2021-05-09 00:00:00,148,298,강원도,147692,26339
800794,81836,2021-05-09 00:00:00,2561,11230,경기도,803355,93066
135574,24854,2021-05-09 00:00:00,184,541,충청북도,135758,25395
178633,23952,2021-05-09 00:00:00,329,2230,충청남도,178962,26182
186062,25710,2021-05-09 00:00:00,251,344,전라북도,186313,26054
218427,31021,2021-05-09 00:00:00,321,879,전라남도,218748,31900
234762,29726,2021-05-09 00:00:00,430,4530,경상북도,235192,34256
261266,34985,2021-05-09 00:00:00,411,1816,경상남도,261677,36801
45604,10082,2021-05-09 00:00:00,135,103,제주특별자치도,45739,10185
3674726,501540,2021-05-10 00:00:00,3,4734,전국,3674729,506274
591041,73295,2021-05-10 00:00:00,0,0,서울특별시,591041,73295
230607,23995,2021-05-10 00:00:00,0,0,부산광역시,230607,23995
156962,19196,2021-05-10 00:00:00,0,1028,대구광역시,156962,20224
181511,30551,2021-05-10 00:00:00,0,0,인천광역시,181511,30551
116508,14748,2021-05-10 00:00:00,0,0,광주광역시,116508,14748
18448,4697,2021-05-10 00:00:00,0,0,세종특별자치시,18448,4697
104444,12119,2021-05-10 00:00:00,0,0,대전광역시,104444,12119
803370,93067,2021-05-10 00:00:00,1,1288,경기도,803371,94355
61752,12760,2021-05-10 00:00:00,0,0,울산광역시,61752,12760
147692,26339,2021-05-10 00:00:00,0,0,강원도,147692,26339
135758,25395,2021-05-10 00:00:00,0,0,충청북도,135758,25395
178963,26182,2021-05-10 00:00:00,2,777,충청남도,178965,26959
186313,26054,2021-05-10 00:00:00,0,0,전라북도,186313,26054
218748,31900,2021-05-10 00:00:00,0,0,전라남도,218748,31900
235192,34256,2021-05-10 00:00:00,0,1641,경상북도,235192,35897
261678,36801,2021-05-10 00:00:00,0,0,경상남도,261678,36801
45739,10185,2021-05-10 00:00:00,0,0,제주특별자치도,45739,10185
3684225,506462,2021-05-11 00:00:00,8341,77551,전국,3692566,584013
591844,73318,2021-05-11 00:00:00,3131,12457,서울특별시,594975,85775
230900,24004,2021-05-11 00:00:00,11,2885,부산광역시,230911,26889
157126,20230,2021-05-11 00:00:00,284,2675,대구광역시,157410,22905
181842,30579,2021-05-11 00:00:00,122,3009,인천광역시,181964,33588
116581,14751,2021-05-11 00:00:00,764,1203,광주광역시,117345,15954
104730,12128,2021-05-11 00:00:00,220,2226,대전광역시,104950,14354
61782,12760,2021-05-11 00:00:00,4,787,울산광역시,61786,13547
18614,4698,2021-05-11 00:00:00,8,591,세종특별자치시,18622,5289
807018,94396,2021-05-11 00:00:00,626,15181,경기도,807644,109577
149215,26355,2021-05-11 00:00:00,22,3086,강원도,149237,29441
135997,25403,2021-05-11 00:00:00,260,2373,충청북도,136257,27776
179430,26967,2021-05-11 00:00:00,167,6221,충청남도,179597,33188
186424,26064,2021-05-11 00:00:00,287,3078,전라북도,186711,29142
218962,31914,2021-05-11 00:00:00,2216,5623,전라남도,221178,37537
235552,35900,2021-05-11 00:00:00,158,8143,경상북도,235710,44043
262344,36810,2021-05-11 00:00:00,55,7270,경상남도,262399,44080
45864,10185,2021-05-11 00:00:00,6,743,제주특별자치도,45870,10928
3692628,584025,2021-05-12 00:00:00,6029,80788,전국,3698657,664813
595470,85780,2021-05-12 00:00:00,2796,13030,서울특별시,598266,98810
230910,26889,2021-05-12 00:00:00,121,2631,부산광역시,231031,29520
157592,22905,2021-05-12 00:00:00,100,2666,대구광역시,157692,25571
182015,33588,2021-05-12 00:00:00,98,3021,인천광역시,182113,36609
117348,15954,2021-05-12 00:00:00,21,2633,광주광역시,117369,18587
105077,14355,2021-05-12 00:00:00,283,2167,대전광역시,105360,16522
61789,13547,2021-05-12 00:00:00,11,717,울산광역시,61800,14264
18752,5289,2021-05-12 00:00:00,25,548,세종특별자치시,18777,5837
804916,109578,2021-05-12 00:00:00,517,16269,경기도,805433,125847
149640,29441,2021-05-12 00:00:00,50,3373,강원도,149690,32814
179953,33191,2021-05-12 00:00:00,224,6160,충청남도,180177,39351
186717,29142,2021-05-12 00:00:00,147,3144,전라북도,186864,32286
136483,27776,2021-05-12 00:00:00,164,3419,충청북도,136647,31195
221219,37538,2021-05-12 00:00:00,1328,4799,전라남도,222547,42337
235788,44043,2021-05-12 00:00:00,96,8499,경상북도,235884,52542
263153,44081,2021-05-12 00:00:00,44,6891,경상남도,263197,50972
45806,10928,2021-05-12 00:00:00,4,821,제주특별자치도,45810,11749
3706615,664817,2021-05-13 00:00:00,4408,82890,전국,3711023,747707
598931,98811,2021-05-13 00:00:00,1617,13970,서울특별시,600548,112781
231193,29520,2021-05-13 00:00:00,302,2833,부산광역시,231495,32353
157806,25571,2021-05-13 00:00:00,68,2134,대구광역시,157874,27705
117499,18587,2021-05-13 00:00:00,73,2673,광주광역시,117572,21260
182399,36611,2021-05-13 00:00:00,90,2966,인천광역시,182489,39577
105873,16522,2021-05-13 00:00:00,314,2020,대전광역시,106187,18542
18931,5838,2021-05-13 00:00:00,18,596,세종특별자치시,18949,6434
61815,14264,2021-05-13 00:00:00,45,1481,울산광역시,61860,15745
808968,125848,2021-05-13 00:00:00,652,16256,경기도,809620,142104
150233,32814,2021-05-13 00:00:00,11,2920,강원도,150244,35734
136900,31192,2021-05-13 00:00:00,374,3537,충청북도,137274,34729
180489,39352,2021-05-13 00:00:00,84,7268,충청남도,180573,46620
186995,32286,2021-05-13 00:00:00,158,3194,전라북도,187153,35480
222745,42337,2021-05-13 00:00:00,500,6140,전라남도,223245,48477
236007,52543,2021-05-13 00:00:00,53,7027,경상북도,236060,59570
263949,50972,2021-05-13 00:00:00,42,6797,경상남도,263991,57769
45882,11749,2021-05-13 00:00:00,7,1078,제주특별자치도,45889,12827
3712844,747713,2021-05-14 00:00:00,7139,77987,전국,3719983,825700
600794,112785,2021-05-14 00:00:00,3391,12435,서울특별시,604185,125220
231520,32353,2021-05-14 00:00:00,182,2417,부산광역시,231702,34770
157898,27704,2021-05-14 00:00:00,73,3398,대구광역시,157971,31102
106358,18542,2021-05-14 00:00:00,304,2214,대전광역시,106662,20756
182526,39578,2021-05-14 00:00:00,73,2364,인천광역시,182599,41942
117586,21258,2021-05-14 00:00:00,8,1755,광주광역시,117594,23013
61863,15745,2021-05-14 00:00:00,144,1064,울산광역시,62007,16809
810407,142105,2021-05-14 00:00:00,755,16547,경기도,811162,158652
150306,35734,2021-05-14 00:00:00,316,2318,강원도,150622,38052
18970,6434,2021-05-14 00:00:00,117,289,세종특별자치시,19087,6723
137294,34729,2021-05-14 00:00:00,407,2360,충청북도,137701,37089
180693,46622,2021-05-14 00:00:00,270,5013,충청남도,180963,51635
187171,35480,2021-05-14 00:00:00,135,4529,전라북도,187306,40009
223247,48478,2021-05-14 00:00:00,826,6836,전라남도,224073,55314
236084,59570,2021-05-14 00:00:00,109,5868,경상북도,236193,65438
264158,57769,2021-05-14 00:00:00,23,7671,경상남도,264181,65440
45969,12827,2021-05-14 00:00:00,6,909,제주특별자치도,45975,13736
3721673,825715,2021-05-15 00:00:00,9548,79705,전국,3731221,905420
605555,125222,2021-05-15 00:00:00,3827,12751,서울특별시,609382,137973
231700,34770,2021-05-15 00:00:00,236,2497,부산광역시,231936,37267
158036,31102,2021-05-15 00:00:00,48,3518,대구광역시,158084,34620
117631,23014,2021-05-15 00:00:00,634,2201,광주광역시,118265,25215
182741,41942,2021-05-15 00:00:00,107,2383,인천광역시,182848,44325
19338,6723,2021-05-15 00:00:00,69,354,세종특별자치시,19407,7077
107010,20756,2021-05-15 00:00:00,350,2183,대전광역시,107360,22939
808966,158659,2021-05-15 00:00:00,972,17903,경기도,809938,176562
61987,16809,2021-05-15 00:00:00,156,1009,울산광역시,62143,17818
150840,38052,2021-05-15 00:00:00,672,1884,강원도,151512,39936
137819,37090,2021-05-15 00:00:00,249,2392,충청북도,138068,39482
181334,51637,2021-05-15 00:00:00,154,3684,충청남도,181488,55321
187356,40009,2021-05-15 00:00:00,66,4319,전라북도,187422,44328
224226,55316,2021-05-15 00:00:00,890,6550,전라남도,225116,61866
236276,65438,2021-05-15 00:00:00,48,6159,경상북도,236324,71597
264818,65440,2021-05-15 00:00:00,613,8969,경상남도,265431,74409
46040,13736,2021-05-15 00:00:00,457,949,제주특별자치도,46497,14685
3732527,905528,2021-05-16 00:00:00,1269,29829,전국,3733796,935357
609643,138052,2021-05-16 00:00:00,695,3717,서울특별시,610338,141769
231981,37267,2021-05-16 00:00:00,17,1365,부산광역시,231998,38632
158112,34620,2021-05-16 00:00:00,9,1794,대구광역시,158121,36414
182947,44325,2021-05-16 00:00:00,4,688,인천광역시,182951,45013
118308,25217,2021-05-16 00:00:00,9,375,광주광역시,118317,25592
62147,17818,2021-05-16 00:00:00,0,0,울산광역시,62147,17818
19418,7077,2021-05-16 00:00:00,41,104,세종특별자치시,19459,7181
107385,22939,2021-05-16 00:00:00,0,178,대전광역시,107385,23117
810181,176585,2021-05-16 00:00:00,151,12299,경기도,810332,188884
151558,39936,2021-05-16 00:00:00,0,0,강원도,151558,39936
138070,39482,2021-05-16 00:00:00,3,565,충청북도,138073,40047
181534,55325,2021-05-16 00:00:00,6,1826,충청남도,181540,57151
187430,44328,2021-05-16 00:00:00,5,645,전라북도,187435,44973
225185,61866,2021-05-16 00:00:00,18,766,전라남도,225203,62632
236382,71597,2021-05-16 00:00:00,1,2822,경상북도,236383,74419
265726,74409,2021-05-16 00:00:00,183,2595,경상남도,265909,77004
46520,14685,2021-05-16 00:00:00,127,90,제주특별자치도,46647,14775
3733801,935359,2021-05-17 00:00:00,5,4986,전국,3733806,940345
610403,141769,2021-05-17 00:00:00,0,0,서울특별시,610403,141769
231998,38632,2021-05-17 00:00:00,0,0,부산광역시,231998,38632
158116,36414,2021-05-17 00:00:00,3,584,대구광역시,158119,36998
182959,45013,2021-05-17 00:00:00,0,0,인천광역시,182959,45013
107377,23117,2021-05-17 00:00:00,0,0,대전광역시,107377,23117
118327,25592,2021-05-17 00:00:00,0,0,광주광역시,118327,25592
62150,17818,2021-05-17 00:00:00,0,0,울산광역시,62150,17818
19459,7181,2021-05-17 00:00:00,0,0,세종특별자치시,19459,7181
810178,188886,2021-05-17 00:00:00,1,2002,경기도,810179,190888
151552,39936,2021-05-17 00:00:00,0,0,강원도,151552,39936
138072,40047,2021-05-17 00:00:00,0,0,충청북도,138072,40047
181562,57151,2021-05-17 00:00:00,0,397,충청남도,181562,57548
187430,44973,2021-05-17 00:00:00,1,755,전라북도,187431,45728
225221,62632,2021-05-17 00:00:00,0,0,전라남도,225221,62632
236389,74419,2021-05-17 00:00:00,0,1248,경상북도,236389,75667
265967,77004,2021-05-17 00:00:00,0,0,경상남도,265967,77004
46641,14775,2021-05-17 00:00:00,0,0,제주특별자치도,46641,14775
3733928,940694,2021-05-18 00:00:00,12006,98948,전국,3745934,1039642
610433,141824,2021-05-18 00:00:00,3197,13074,서울특별시,613630,154898
232010,38723,2021-05-18 00:00:00,575,4789,부산광역시,232585,43512
158149,36998,2021-05-18 00:00:00,47,3729,대구광역시,158196,40727
182966,44993,2021-05-18 00:00:00,159,4153,인천광역시,183125,49146
107374,23118,2021-05-18 00:00:00,483,2810,대전광역시,107857,25928
118332,25672,2021-05-18 00:00:00,658,3431,광주광역시,118990,29103
19461,7181,2021-05-18 00:00:00,139,285,세종특별자치시,19600,7466
810201,190961,2021-05-18 00:00:00,1150,22514,경기도,811351,213475
62149,17819,2021-05-18 00:00:00,690,942,울산광역시,62839,18761
151557,39944,2021-05-18 00:00:00,696,3088,강원도,152253,43032
138069,40047,2021-05-18 00:00:00,248,4454,충청북도,138317,44501
181572,57550,2021-05-18 00:00:00,1642,3201,충청남도,183214,60751
187433,45728,2021-05-18 00:00:00,89,9563,전라북도,187522,55291
225221,62668,2021-05-18 00:00:00,1176,7187,전라남도,226397,69855
236390,75690,2021-05-18 00:00:00,51,7337,경상북도,236441,83027
265969,77004,2021-05-18 00:00:00,800,7367,경상남도,266769,84371
46642,14774,2021-05-18 00:00:00,206,1024,제주특별자치도,46848,15798
3747236,1040603,2021-05-19 00:00:00,11822,139678,전국,3759058,1180281
613716,155071,2021-05-19 00:00:00,2983,16649,서울특별시,616699,171720
232672,43538,2021-05-19 00:00:00,812,8930,부산광역시,233484,52468
158223,40811,2021-05-19 00:00:00,119,6011,대구광역시,158342,46822
107991,25971,2021-05-19 00:00:00,247,4321,대전광역시,108238,30292
183210,49174,2021-05-19 00:00:00,252,5843,인천광역시,183462,55017
119006,29107,2021-05-19 00:00:00,441,5114,광주광역시,119447,34221
62846,18874,2021-05-19 00:00:00,294,2029,울산광역시,63140,20903
811720,213886,2021-05-19 00:00:00,1354,30523,경기도,813074,244409
152344,43033,2021-05-19 00:00:00,338,5333,강원도,152682,48366
19613,7466,2021-05-19 00:00:00,128,264,세종특별자치시,19741,7730
138353,44513,2021-05-19 00:00:00,304,6030,충청북도,138657,50543
183260,60741,2021-05-19 00:00:00,1765,5438,충청남도,185025,66179
187523,55303,2021-05-19 00:00:00,190,11532,전라북도,187713,66835
226409,69914,2021-05-19 00:00:00,1492,10220,전라남도,227901,80134
236485,83028,2021-05-19 00:00:00,59,6997,경상북도,236544,90025
266986,84375,2021-05-19 00:00:00,798,13068,경상남도,267784,97443
46879,15798,2021-05-19 00:00:00,246,1376,제주특별자치도,47125,17174
3759157,1180516,2021-05-20 00:00:00,1783,92694,전국,3760940,1273210
616691,171721,2021-05-20 00:00:00,14,3724,서울특별시,616705,175445
233490,52468,2021-05-20 00:00:00,50,7565,부산광역시,233540,60033
158336,46900,2021-05-20 00:00:00,15,4565,대구광역시,158351,51465
183475,55017,2021-05-20 00:00:00,5,4363,인천광역시,183480,59380
108355,30292,2021-05-20 00:00:00,5,867,대전광역시,108360,31159
119454,34272,2021-05-20 00:00:00,266,1784,광주광역시,119720,36056
63139,20903,2021-05-20 00:00:00,11,1039,울산광역시,63150,21942
19748,7730,2021-05-20 00:00:00,104,307,세종특별자치시,19852,8037
813053,244409,2021-05-20 00:00:00,625,28132,경기도,813678,272541
152667,48366,2021-05-20 00:00:00,8,3354,강원도,152675,51720
138650,50563,2021-05-20 00:00:00,32,4922,충청북도,138682,55485
185019,66204,2021-05-20 00:00:00,19,4983,충청남도,185038,71187
187714,66835,2021-05-20 00:00:00,41,10083,전라북도,187755,76918
227895,80183,2021-05-20 00:00:00,564,5814,전라남도,228459,85997
236537,90037,2021-05-20 00:00:00,9,3776,경상북도,236546,93813
267811,97442,2021-05-20 00:00:00,10,6368,경상남도,267821,103810
47123,17174,2021-05-20 00:00:00,5,1048,제주특별자치도,47128,18222
3761416,1275047,2021-05-21 00:00:00,11183,207795,전국,3772599,1482842
616812,175870,2021-05-21 00:00:00,2205,22755,서울특별시,619017,198625
233569,60110,2021-05-21 00:00:00,409,17845,부산광역시,233978,77955
158375,51466,2021-05-21 00:00:00,118,8803,대구광역시,158493,60269
119756,36190,2021-05-21 00:00:00,472,5547,광주광역시,120228,41737
183503,59495,2021-05-21 00:00:00,217,10902,인천광역시,183720,70397
19848,8037,2021-05-21 00:00:00,87,435,세종특별자치시,19935,8472
108365,31172,2021-05-21 00:00:00,99,5920,대전광역시,108464,37092
813827,272966,2021-05-21 00:00:00,1888,48307,경기도,815715,321273
63161,22010,2021-05-21 00:00:00,386,3111,울산광역시,63547,25121
152681,51730,2021-05-21 00:00:00,377,8511,강원도,153058,60241
138697,55572,2021-05-21 00:00:00,632,7943,충청북도,139329,63515
185059,71340,2021-05-21 00:00:00,174,11005,충청남도,185233,82345
187760,76955,2021-05-21 00:00:00,596,11910,전라북도,188356,88865
228475,86221,2021-05-21 00:00:00,788,12619,전라남도,229263,98840
236553,93855,2021-05-21 00:00:00,1214,14827,경상북도,237767,108682
267848,103836,2021-05-21 00:00:00,932,16022,경상남도,268780,119858
47127,18222,2021-05-21 00:00:00,589,1333,제주특별자치도,47716,19555
3773806,1485612,2021-05-22 00:00:00,13764,221916,전국,3787570,1707528
619192,199044,2021-05-22 00:00:00,2271,28449,서울특별시,621463,227493
234026,78373,2021-05-22 00:00:00,496,18963,부산광역시,234522,97336
183773,70606,2021-05-22 00:00:00,267,12774,인천광역시,184040,83380
158615,60384,2021-05-22 00:00:00,278,10810,대구광역시,158893,71194
108494,37099,2021-05-22 00:00:00,94,6567,대전광역시,108588,43666
120277,41833,2021-05-22 00:00:00,406,6206,광주광역시,120683,48039
63554,25187,2021-05-22 00:00:00,538,3661,울산광역시,64092,28848
816000,321930,2021-05-22 00:00:00,2351,53596,경기도,818351,375526
153122,60302,2021-05-22 00:00:00,399,8226,강원도,153521,68528
19937,8472,2021-05-22 00:00:00,208,385,세종특별자치시,20145,8857
139358,63601,2021-05-22 00:00:00,1177,6807,충청북도,140535,70408
185261,82525,2021-05-22 00:00:00,142,11141,충청남도,185403,93666
188369,88866,2021-05-22 00:00:00,1399,8770,전라북도,189768,97636
229323,98968,2021-05-22 00:00:00,699,12553,전라남도,230022,111521
237879,108785,2021-05-22 00:00:00,2112,15946,경상북도,239991,124731
268899,120082,2021-05-22 00:00:00,788,15551,경상남도,269687,135633
47727,19555,2021-05-22 00:00:00,139,1511,제주특별자치도,47866,21066
3787727,1708854,2021-05-23 00:00:00,4933,34583,전국,3792660,1743437
621464,227721,2021-05-23 00:00:00,2477,4099,서울특별시,623941,231820
234523,97622,2021-05-23 00:00:00,39,2365,부산광역시,234562,99987
158908,71458,2021-05-23 00:00:00,19,1366,대구광역시,158927,72824
184047,83492,2021-05-23 00:00:00,27,2713,인천광역시,184074,86205
108605,43666,2021-05-23 00:00:00,1,258,대전광역시,108606,43924
120686,48086,2021-05-23 00:00:00,49,2947,광주광역시,120735,51033
64092,28860,2021-05-23 00:00:00,18,755,울산광역시,64110,29615
818379,375742,2021-05-23 00:00:00,1639,10679,경기도,820018,386421
153519,68535,2021-05-23 00:00:00,304,672,강원도,153823,69207
20146,8857,2021-05-23 00:00:00,71,123,세종특별자치시,20217,8980
140559,70411,2021-05-23 00:00:00,8,401,충청북도,140567,70812
185413,93707,2021-05-23 00:00:00,20,868,충청남도,185433,94575
189767,97644,2021-05-23 00:00:00,27,865,전라북도,189794,98509
230047,111563,2021-05-23 00:00:00,98,1300,전라남도,230145,112863
239997,124786,2021-05-23 00:00:00,23,1753,경상북도,240020,126539
269709,135638,2021-05-23 00:00:00,62,3040,경상남도,269771,138678
47866,21066,2021-05-23 00:00:00,51,379,제주특별자치도,47917,21445
3792689,1743627,2021-05-24 00:00:00,217,2709,전국,3792906,1746336
623942,231821,2021-05-24 00:00:00,0,0,서울특별시,623942,231821
234563,99987,2021-05-24 00:00:00,1,20,부산광역시,234564,100007
158928,72852,2021-05-24 00:00:00,5,1072,대구광역시,158933,73924
184077,86224,2021-05-24 00:00:00,1,708,인천광역시,184078,86932
120734,51033,2021-05-24 00:00:00,8,634,광주광역시,120742,51667
108630,43959,2021-05-24 00:00:00,0,0,대전광역시,108630,43959
20218,8980,2021-05-24 00:00:00,0,0,세종특별자치시,20218,8980
820011,386438,2021-05-24 00:00:00,202,25,경기도,820213,386463
64110,29617,2021-05-24 00:00:00,0,0,울산광역시,64110,29617
153821,69207,2021-05-24 00:00:00,0,77,강원도,153821,69284
140570,70812,2021-05-24 00:00:00,0,0,충청북도,140570,70812
185433,94660,2021-05-24 00:00:00,0,4,충청남도,185433,94664
189794,98509,2021-05-24 00:00:00,0,24,전라북도,189794,98533
230146,112863,2021-05-24 00:00:00,0,0,전라남도,230146,112863
240023,126542,2021-05-24 00:00:00,0,0,경상북도,240023,126542
269772,138678,2021-05-24 00:00:00,0,13,경상남도,269772,138691
47917,21445,2021-05-24 00:00:00,0,132,제주특별자치도,47917,21577
3793492,1748792,2021-05-25 00:00:00,71292,101877,전국,3864784,1850669
624007,232004,2021-05-25 00:00:00,7688,21524,서울특별시,631695,253528
234622,100442,2021-05-25 00:00:00,4834,8049,부산광역시,239456,108491
158944,74093,2021-05-25 00:00:00,2122,4540,대구광역시,161066,78633
184154,86987,2021-05-25 00:00:00,3169,4630,인천광역시,187323,91617
120783,51912,2021-05-25 00:00:00,2121,3384,광주광역시,122904,55296
108639,44067,2021-05-25 00:00:00,430,4114,대전광역시,109069,48181
20213,8980,2021-05-25 00:00:00,40,433,세종특별자치시,20253,9413
64141,29638,2021-05-25 00:00:00,668,2307,울산광역시,64809,31945
820387,387240,2021-05-25 00:00:00,17385,16135,경기도,837772,403375
153831,69293,2021-05-25 00:00:00,3704,1906,강원도,157535,71199
140592,70843,2021-05-25 00:00:00,3813,2635,충청북도,144405,73478
185441,94761,2021-05-25 00:00:00,6439,4796,충청남도,191880,99557
189793,98546,2021-05-25 00:00:00,4393,2907,전라북도,194186,101453
230168,112914,2021-05-25 00:00:00,3454,7835,전라남도,233622,120749
240063,126684,2021-05-25 00:00:00,2858,8457,경상북도,242921,135141
269793,138808,2021-05-25 00:00:00,7392,6712,경상남도,277185,145520
47921,21580,2021-05-25 00:00:00,782,1513,제주특별자치도,48703,23093
3865303,1853619,2021-05-26 00:00:00,77472,91598,전국,3942775,1945217
631735,253739,2021-05-26 00:00:00,7748,21010,서울특별시,639483,274749
239495,108922,2021-05-26 00:00:00,6971,5834,부산광역시,246466,114756
187355,91726,2021-05-26 00:00:00,3982,3632,인천광역시,191337,95358
161085,78842,2021-05-26 00:00:00,2617,4250,대구광역시,163702,83092
109071,48231,2021-05-26 00:00:00,677,4108,대전광역시,109748,52339
122921,55537,2021-05-26 00:00:00,857,4099,광주광역시,123778,59636
64825,31945,2021-05-26 00:00:00,1505,1239,울산광역시,66330,33184
20254,9413,2021-05-26 00:00:00,53,232,세종특별자치시,20307,9645
837949,403819,2021-05-26 00:00:00,17996,15576,경기도,855945,419395
157563,71301,2021-05-26 00:00:00,3927,1960,강원도,161490,73261
144417,73583,2021-05-26 00:00:00,4302,2265,충청북도,148719,75848
194189,101531,2021-05-26 00:00:00,5572,3027,전라북도,199761,104558
191889,99929,2021-05-26 00:00:00,5494,2986,충청남도,197383,102915
233666,121058,2021-05-26 00:00:00,2845,8251,전라남도,236511,129309
242942,135346,2021-05-26 00:00:00,3094,5900,경상북도,246036,141246
277244,145592,2021-05-26 00:00:00,8313,6236,경상남도,285557,151828
48703,23105,2021-05-26 00:00:00,1519,993,제주특별자치도,50222,24098
3943579,1946983,2021-05-27 00:00:00,87165,65936,전국,4030744,2012919
639652,274943,2021-05-27 00:00:00,10780,16175,서울특별시,650432,291118
246477,114877,2021-05-27 00:00:00,7873,4058,부산광역시,254350,118935
163799,83221,2021-05-27 00:00:00,3886,3776,대구광역시,167685,86997
191361,95500,2021-05-27 00:00:00,4790,2314,인천광역시,196151,97814
123795,59761,2021-05-27 00:00:00,2277,2197,광주광역시,126072,61958
109766,52351,2021-05-27 00:00:00,2050,2451,대전광역시,111816,54802
66339,33187,2021-05-27 00:00:00,921,815,울산광역시,67260,34002
20307,9645,2021-05-27 00:00:00,37,314,세종특별자치시,20344,9959
856048,419854,2021-05-27 00:00:00,19803,12830,경기도,875851,432684
161506,73272,2021-05-27 00:00:00,3868,2018,강원도,165374,75290
148743,75937,2021-05-27 00:00:00,3731,1581,충청북도,152474,77518
197451,103132,2021-05-27 00:00:00,4258,2558,충청남도,201709,105690
199761,104575,2021-05-27 00:00:00,5602,2930,전라북도,205363,107505
236538,129319,2021-05-27 00:00:00,5111,3655,전라남도,241649,132974
246170,141405,2021-05-27 00:00:00,3418,4315,경상북도,249588,145720
285580,151866,2021-05-27 00:00:00,7738,3319,경상남도,293318,155185
50286,24138,2021-05-27 00:00:00,1022,630,제주특별자치도,51308,24768
4031328,2014875,2021-05-28 00:00:00,657192,54002,전국,4688520,2068877
650507,291275,2021-05-28 00:00:00,122034,13061,서울특별시,772541,304336
254434,119060,2021-05-28 00:00:00,51650,2726,부산광역시,306084,121786
167716,87180,2021-05-28 00:00:00,25752,3402,대구광역시,193468,90582
196237,98101,2021-05-28 00:00:00,33686,1779,인천광역시,229923,99880
111835,54834,2021-05-28 00:00:00,17000,1870,대전광역시,128835,56704
126090,61995,2021-05-28 00:00:00,19427,2054,광주광역시,145517,64049
875925,433272,2021-05-28 00:00:00,149748,10333,경기도,1025673,443605
67271,34070,2021-05-28 00:00:00,11899,754,울산광역시,79170,34824
165365,75353,2021-05-28 00:00:00,23303,1772,강원도,188668,77125
20345,9959,2021-05-28 00:00:00,3560,277,세종특별자치시,23905,10236
152513,77542,2021-05-28 00:00:00,22787,1457,충청북도,175300,78999
201770,105725,2021-05-28 00:00:00,28952,2072,충청남도,230722,107797
205368,107529,2021-05-28 00:00:00,31264,2435,전라북도,236632,109964
241669,133008,2021-05-28 00:00:00,34599,3187,전라남도,276268,136195
249627,145941,2021-05-28 00:00:00,32811,2996,경상북도,282438,148937
293347,155250,2021-05-28 00:00:00,40839,2887,경상남도,334186,158137
51309,24781,2021-05-28 00:00:00,7881,940,제주특별자치도,59190,25721
4691736,2069844,2021-05-29 00:00:00,542227,63876,전국,5233963,2133720
773069,304415,2021-05-29 00:00:00,104641,17031,서울특별시,877710,321446
306303,121840,2021-05-29 00:00:00,43269,5109,부산광역시,349572,126949
193630,90635,2021-05-29 00:00:00,20741,4649,대구광역시,214371,95284
230064,99950,2021-05-29 00:00:00,27377,1816,인천광역시,257441,101766
145595,64134,2021-05-29 00:00:00,16296,2096,광주광역시,161891,66230
128932,56758,2021-05-29 00:00:00,15277,1551,대전광역시,144209,58309
79185,34826,2021-05-29 00:00:00,10088,997,울산광역시,89273,35823
23916,10237,2021-05-29 00:00:00,2731,166,세종특별자치시,26647,10403
1026553,443902,2021-05-29 00:00:00,122380,12388,경기도,1148933,456290
188786,77126,2021-05-29 00:00:00,20313,1703,강원도,209099,78829
175425,79059,2021-05-29 00:00:00,18024,1217,충청북도,193449,80276
230816,107809,2021-05-29 00:00:00,22809,1958,충청남도,253625,109767
236667,109966,2021-05-29 00:00:00,25833,3070,전라북도,262500,113036
276556,136318,2021-05-29 00:00:00,27551,3821,전라남도,304107,140139
282759,148972,2021-05-29 00:00:00,26556,2224,경상북도,309315,151196
334243,158176,2021-05-29 00:00:00,31445,3025,경상남도,365688,161201
59237,25721,2021-05-29 00:00:00,6896,1055,제주특별자치도,66133,26776
5235558,2134761,2021-05-30 00:00:00,163457,8532,전국,5399015,2143293
878158,321499,2021-05-30 00:00:00,33401,3580,서울특별시,911559,325079
349655,126986,2021-05-30 00:00:00,13192,992,부산광역시,362847,127978
214412,95311,2021-05-30 00:00:00,6807,323,대구광역시,221219,95634
257461,101770,2021-05-30 00:00:00,9342,185,인천광역시,266803,101955
161943,66240,2021-05-30 00:00:00,5108,784,광주광역시,167051,67024
144221,58499,2021-05-30 00:00:00,3483,268,대전광역시,147704,58767
89294,35825,2021-05-30 00:00:00,2693,102,울산광역시,91987,35927
26663,10403,2021-05-30 00:00:00,1049,41,세종특별자치시,27712,10444
1149376,456752,2021-05-30 00:00:00,44600,759,경기도,1193976,457511
209126,78934,2021-05-30 00:00:00,3914,173,강원도,213040,79107
193540,80359,2021-05-30 00:00:00,5392,49,충청북도,198932,80408
253658,109767,2021-05-30 00:00:00,5728,127,충청남도,259386,109894
262518,113037,2021-05-30 00:00:00,6333,177,전라북도,268851,113214
304148,140190,2021-05-30 00:00:00,6863,226,전라남도,311011,140416
309436,151196,2021-05-30 00:00:00,5687,169,경상북도,315123,151365
365809,161207,2021-05-30 00:00:00,8180,537,경상남도,373989,161744
66140,26786,2021-05-30 00:00:00,1685,40,제주특별자치도,67825,26826
5399144,2143298,2021-05-31 00:00:00,4710,87,전국,5403854,2143385
911567,325079,2021-05-31 00:00:00,950,0,서울특별시,912517,325079
362848,127979,2021-05-31 00:00:00,257,0,부산광역시,363105,127979
221216,95634,2021-05-31 00:00:00,90,9,대구광역시,221306,95643
266814,101956,2021-05-31 00:00:00,288,8,인천광역시,267102,101964
91986,35927,2021-05-31 00:00:00,71,0,울산광역시,92057,35927
167050,67024,2021-05-31 00:00:00,48,0,광주광역시,167098,67024
147704,58767,2021-05-31 00:00:00,81,0,대전광역시,147785,58767
27711,10444,2021-05-31 00:00:00,8,0,세종특별자치시,27719,10444
1194004,457514,2021-05-31 00:00:00,2240,9,경기도,1196244,457523
213057,79107,2021-05-31 00:00:00,88,61,강원도,213145,79168
198949,80408,2021-05-31 00:00:00,143,0,충청북도,199092,80408
259382,109894,2021-05-31 00:00:00,125,0,충청남도,259507,109894
268858,113214,2021-05-31 00:00:00,97,0,전라북도,268955,113214
311011,140416,2021-05-31 00:00:00,41,0,전라남도,311052,140416
315126,151365,2021-05-31 00:00:00,67,0,경상북도,315193,151365
374035,161744,2021-05-31 00:00:00,57,0,경상남도,374092,161744
67826,26826,2021-05-31 00:00:00,59,0,제주특별자치도,67885,26826
5405968,2144272,2021-06-01 00:00:00,385535,27064,전국,5791503,2171336
912940,325342,2021-06-01 00:00:00,75387,8127,서울특별시,988327,333469
363185,128019,2021-06-01 00:00:00,30971,1190,부산광역시,394156,129209
221401,95667,2021-06-01 00:00:00,13922,1171,대구광역시,235323,96838
167177,67042,2021-06-01 00:00:00,10646,1355,광주광역시,177823,68397
267203,102017,2021-06-01 00:00:00,18567,716,인천광역시,285770,102733
92106,35933,2021-06-01 00:00:00,7085,192,울산광역시,99191,36125
27723,10445,2021-06-01 00:00:00,1496,30,세종특별자치시,29219,10475
147834,58769,2021-06-01 00:00:00,11060,1032,대전광역시,158894,59801
213282,79169,2021-06-01 00:00:00,12750,823,강원도,226032,79992
199141,80438,2021-06-01 00:00:00,14424,538,충청북도,213565,80976
1196965,457874,2021-06-01 00:00:00,80234,4896,경기도,1277199,462770
259559,109922,2021-06-01 00:00:00,18800,921,충청남도,278359,110843
268990,113218,2021-06-01 00:00:00,19924,1380,전라북도,288914,114598
311111,140446,2021-06-01 00:00:00,19012,3076,전라남도,330123,143522
315266,151379,2021-06-01 00:00:00,22411,775,경상북도,337677,152154
374159,161766,2021-06-01 00:00:00,23608,692,경상남도,397767,162458
67926,26826,2021-06-01 00:00:00,5238,150,제주특별자치도,73164,26976
5793135,2172065,2021-06-02 00:00:00,565377,25945,전국,6358512,2198010
988706,333515,2021-06-02 00:00:00,103600,7109,서울특별시,1092306,340624
394247,129326,2021-06-02 00:00:00,44891,1507,부산광역시,439138,130833
235373,96888,2021-06-02 00:00:00,22868,1221,대구광역시,258241,98109
285867,102781,2021-06-02 00:00:00,28655,868,인천광역시,314522,103649
159034,59803,2021-06-02 00:00:00,14360,1013,대전광역시,173394,60816
177847,68420,2021-06-02 00:00:00,16806,795,광주광역시,194653,69215
99205,36183,2021-06-02 00:00:00,10701,122,울산광역시,109906,36305
29229,10475,2021-06-02 00:00:00,2247,42,세종특별자치시,31476,10517
226098,79992,2021-06-02 00:00:00,19585,1049,강원도,245683,81041
213575,80985,2021-06-02 00:00:00,22031,517,충청북도,235606,81502
1277596,463079,2021-06-02 00:00:00,114747,5025,경기도,1392343,468104
278391,110893,2021-06-02 00:00:00,27968,963,충청남도,306359,111856
288968,114599,2021-06-02 00:00:00,27619,1238,전라북도,316587,115837
330243,143530,2021-06-02 00:00:00,30452,2164,전라남도,360695,145694
337788,152155,2021-06-02 00:00:00,33742,1286,경상북도,371530,153441
397796,162465,2021-06-02 00:00:00,37584,898,경상남도,435380,163363
73172,26976,2021-06-02 00:00:00,7521,128,제주특별자치도,80693,27104
6360442,2198499,2021-06-03 00:00:00,381551,22229,전국,6741993,2220728
1092673,340659,2021-06-03 00:00:00,73063,6277,서울특별시,1165736,346936
439257,130847,2021-06-03 00:00:00,31246,1313,부산광역시,470503,132160
258318,98109,2021-06-03 00:00:00,15688,929,대구광역시,274006,99038
314582,103666,2021-06-03 00:00:00,18911,746,인천광역시,333493,104412
109937,36306,2021-06-03 00:00:00,6611,222,울산광역시,116548,36528
194713,69253,2021-06-03 00:00:00,10075,685,광주광역시,204788,69938
31488,10517,2021-06-03 00:00:00,1408,72,세종특별자치시,32896,10589
173406,60874,2021-06-03 00:00:00,10312,1024,대전광역시,183718,61898
1393063,468260,2021-06-03 00:00:00,74413,4772,경기도,1467476,473032
245741,81087,2021-06-03 00:00:00,13960,957,강원도,259701,82044
235713,81551,2021-06-03 00:00:00,13941,580,충청북도,249654,82131
306416,111859,2021-06-03 00:00:00,17528,823,충청남도,323944,112682
316608,115837,2021-06-03 00:00:00,18482,446,전라북도,335090,116283
360759,145713,2021-06-03 00:00:00,20270,1558,전라남도,381029,147271
371652,153491,2021-06-03 00:00:00,25911,713,경상북도,397563,154204
435413,163366,2021-06-03 00:00:00,24382,959,경상남도,459795,164325
80703,27104,2021-06-03 00:00:00,5350,153,제주특별자치도,86053,27257
6743716,2221504,2021-06-04 00:00:00,342576,25504,전국,7086292,2247008
1166076,347016,2021-06-04 00:00:00,66402,8383,서울특별시,1232478,355399
470595,132176,2021-06-04 00:00:00,29515,1387,부산광역시,500110,133563
274108,99061,2021-06-04 00:00:00,15047,896,대구광역시,289155,99957
333590,104517,2021-06-04 00:00:00,17626,798,인천광역시,351216,105315
204859,69952,2021-06-04 00:00:00,8733,994,광주광역시,213592,70946
32900,10589,2021-06-04 00:00:00,1359,163,세종특별자치시,34259,10752
183757,61910,2021-06-04 00:00:00,9007,861,대전광역시,192764,62771
116609,36534,2021-06-04 00:00:00,5785,91,울산광역시,122394,36625
1468077,473351,2021-06-04 00:00:00,68068,5311,경기도,1536145,478662
259720,82104,2021-06-04 00:00:00,12644,1457,강원도,272364,83561
249722,82140,2021-06-04 00:00:00,10992,700,충청북도,260714,82840
323967,112728,2021-06-04 00:00:00,15235,322,충청남도,339202,113050
335119,116283,2021-06-04 00:00:00,16661,421,전라북도,351780,116704
381088,147303,2021-06-04 00:00:00,16717,1700,전라남도,397805,149003
397607,154221,2021-06-04 00:00:00,22919,928,경상북도,420526,155149
459853,164362,2021-06-04 00:00:00,20663,974,경상남도,480516,165336
86069,27257,2021-06-04 00:00:00,5203,118,제주특별자치도,91272,27375
7087965,2247553,2021-06-05 00:00:00,367761,29584,전국,7455726,2277137
1232925,355450,2021-06-05 00:00:00,76685,10339,서울특별시,1309610,365789
500199,133645,2021-06-05 00:00:00,32555,1674,부산광역시,532754,135319
289276,99958,2021-06-05 00:00:00,16202,630,대구광역시,305478,100588
213654,70951,2021-06-05 00:00:00,8607,1226,광주광역시,222261,72177
351275,105326,2021-06-05 00:00:00,19691,1066,인천광역시,370966,106392
192775,62772,2021-06-05 00:00:00,10265,951,대전광역시,203040,63723
34267,10752,2021-06-05 00:00:00,1347,136,세종특별자치시,35614,10888
122406,36637,2021-06-05 00:00:00,6409,325,울산광역시,128815,36962
1536480,478766,2021-06-05 00:00:00,78297,5708,경기도,1614777,484474
272509,83663,2021-06-05 00:00:00,12763,2024,강원도,285272,85687
260744,82889,2021-06-05 00:00:00,10003,643,충청북도,270747,83532
339248,113091,2021-06-05 00:00:00,14292,415,충청남도,353540,113506
351804,116705,2021-06-05 00:00:00,15816,344,전라북도,367620,117049
397887,149005,2021-06-05 00:00:00,15342,1826,전라남도,413229,150831
420643,155197,2021-06-05 00:00:00,22285,659,경상북도,442928,155856
480585,165368,2021-06-05 00:00:00,22547,968,경상남도,503132,166336
91288,27378,2021-06-05 00:00:00,4655,650,제주특별자치도,95943,28028
7456423,2277245,2021-06-06 00:00:00,138649,2351,전국,7595072,2279596
1309785,365791,2021-06-06 00:00:00,31613,1135,서울특별시,1341398,366926
532797,135331,2021-06-06 00:00:00,11510,113,부산광역시,544307,135444
305525,100588,2021-06-06 00:00:00,5368,57,대구광역시,310893,100645
222274,72177,2021-06-06 00:00:00,3499,51,광주광역시,225773,72228
370987,106397,2021-06-06 00:00:00,8000,25,인천광역시,378987,106422
203059,63775,2021-06-06 00:00:00,2692,71,대전광역시,205751,63846
128820,36963,2021-06-06 00:00:00,2183,13,울산광역시,131003,36976
1614954,484483,2021-06-06 00:00:00,39815,273,경기도,1654769,484756
285297,85687,2021-06-06 00:00:00,2979,21,강원도,288276,85708
35626,10888,2021-06-06 00:00:00,634,52,세종특별자치시,36260,10940
270755,83533,2021-06-06 00:00:00,4596,52,충청북도,275351,83585
353560,113506,2021-06-06 00:00:00,4049,10,충청남도,357609,113516
367663,117049,2021-06-06 00:00:00,4046,32,전라북도,371709,117081
413255,150854,2021-06-06 00:00:00,4616,15,전라남도,417871,150869
442955,155856,2021-06-06 00:00:00,5186,105,경상북도,448141,155961
503156,166339,2021-06-06 00:00:00,6615,193,경상남도,509771,166532
95955,28028,2021-06-06 00:00:00,1248,133,제주특별자치도,97203,28161
7595829,2279682,2021-06-07 00:00:00,2958,0,전국,7598787,2279682
1341527,366927,2021-06-07 00:00:00,463,0,서울특별시,1341990,366927
544361,135444,2021-06-07 00:00:00,256,0,부산광역시,544617,135444
310917,100645,2021-06-07 00:00:00,57,0,대구광역시,310974,100645
379033,106422,2021-06-07 00:00:00,151,0,인천광역시,379184,106422
205777,63846,2021-06-07 00:00:00,46,0,대전광역시,205823,63846
225788,72228,2021-06-07 00:00:00,23,0,광주광역시,225811,72228
131012,36976,2021-06-07 00:00:00,95,0,울산광역시,131107,36976
36266,10940,2021-06-07 00:00:00,0,0,세종특별자치시,36266,10940
1654979,484840,2021-06-07 00:00:00,1536,0,경기도,1656515,484840
288297,85709,2021-06-07 00:00:00,49,0,강원도,288346,85709
275377,83585,2021-06-07 00:00:00,49,0,충청북도,275426,83585
357635,113516,2021-06-07 00:00:00,50,0,충청남도,357685,113516
371719,117081,2021-06-07 00:00:00,40,0,전라북도,371759,117081
417888,150869,2021-06-07 00:00:00,26,0,전라남도,417914,150869
448177,155961,2021-06-07 00:00:00,30,0,경상북도,448207,155961
509870,166532,2021-06-07 00:00:00,40,0,경상남도,509910,166532
97206,28161,2021-06-07 00:00:00,47,0,제주특별자치도,97253,28161
7600157,2279997,2021-06-08 00:00:00,855642,19856,전국,8455799,2299853
1342258,367006,2021-06-08 00:00:00,158574,5333,서울특별시,1500832,372339
544716,135498,2021-06-08 00:00:00,65946,1277,부산광역시,610662,136775
379197,106451,2021-06-08 00:00:00,45278,710,인천광역시,424475,107161
311098,100646,2021-06-08 00:00:00,34635,242,대구광역시,345733,100888
205830,63846,2021-06-08 00:00:00,21646,866,대전광역시,227476,64712
225840,72240,2021-06-08 00:00:00,24458,1253,광주광역시,250298,73493
131117,36978,2021-06-08 00:00:00,16788,710,울산광역시,147905,37688
36266,10940,2021-06-08 00:00:00,4319,135,세종특별자치시,40585,11075
1657066,484961,2021-06-08 00:00:00,194416,2528,경기도,1851482,487489
288390,85709,2021-06-08 00:00:00,27233,787,강원도,315623,86496
275438,83585,2021-06-08 00:00:00,29982,293,충청북도,305420,83878
357717,113529,2021-06-08 00:00:00,37645,1961,충청남도,395362,115490
371799,117081,2021-06-08 00:00:00,37664,243,전라북도,409463,117324
417944,150869,2021-06-08 00:00:00,40586,1274,전라남도,458530,152143
448293,155965,2021-06-08 00:00:00,47818,460,경상북도,496111,156425
509915,166532,2021-06-08 00:00:00,58152,1498,경상남도,568067,168030
97273,28161,2021-06-08 00:00:00,10502,286,제주특별자치도,107775,28447
8487962,2300509,2021-06-09 00:00:00,714384,24750,전국,9202346,2325259
1505527,372358,2021-06-09 00:00:00,131465,4672,서울특별시,1636992,377030
612447,136912,2021-06-09 00:00:00,54568,2111,부산광역시,667015,139023
347273,100918,2021-06-09 00:00:00,29228,487,대구광역시,376501,101405
426181,107193,2021-06-09 00:00:00,36949,621,인천광역시,463130,107814
148499,37688,2021-06-09 00:00:00,14407,678,울산광역시,162906,38366
251292,73501,2021-06-09 00:00:00,20846,1659,광주광역시,272138,75160
228379,64715,2021-06-09 00:00:00,17982,564,대전광역시,246361,65279
40749,11075,2021-06-09 00:00:00,3051,156,세종특별자치시,43800,11231
1860517,487698,2021-06-09 00:00:00,157396,3430,경기도,2017913,491128
317467,86497,2021-06-09 00:00:00,24416,873,강원도,341883,87370
306721,84042,2021-06-09 00:00:00,25700,735,충청북도,332421,84777
396592,115513,2021-06-09 00:00:00,33331,2214,충청남도,429923,117727
410463,117325,2021-06-09 00:00:00,32015,1132,전라북도,442478,118457
459611,152145,2021-06-09 00:00:00,33762,2219,전라남도,493373,154364
498010,156430,2021-06-09 00:00:00,41237,622,경상북도,539247,157052
570127,168051,2021-06-09 00:00:00,48434,2171,경상남도,618561,170222
108107,28448,2021-06-09 00:00:00,9597,406,제주특별자치도,117704,28854
9232076,2325957,2021-06-10 00:00:00,562087,23528,전국,9794163,2349485
1641551,377124,2021-06-10 00:00:00,104841,3076,서울특별시,1746392,380200
668605,139163,2021-06-10 00:00:00,44841,2533,부산광역시,713446,141696
464666,107846,2021-06-10 00:00:00,28873,1403,인천광역시,493539,109249
377871,101443,2021-06-10 00:00:00,24306,960,대구광역시,402177,102403
247205,65282,2021-06-10 00:00:00,14351,787,대전광역시,261556,66069
272992,75162,2021-06-10 00:00:00,15026,1253,광주광역시,288018,76415
163506,38382,2021-06-10 00:00:00,11999,893,울산광역시,175505,39275
43975,11236,2021-06-10 00:00:00,2159,223,세종특별자치시,46134,11459
2026456,491400,2021-06-10 00:00:00,121812,3708,경기도,2148268,495108
343601,87370,2021-06-10 00:00:00,19943,782,강원도,363544,88152
333491,84777,2021-06-10 00:00:00,19479,906,충청북도,352970,85683
430946,117736,2021-06-10 00:00:00,26340,724,충청남도,457286,118460
443346,118458,2021-06-10 00:00:00,23265,1175,전라북도,466611,119633
494329,154434,2021-06-10 00:00:00,24994,2439,전라남도,519323,156873
540875,157062,2021-06-10 00:00:00,33162,771,경상북도,574037,157833
620589,170227,2021-06-10 00:00:00,38552,1732,경상남도,659141,171959
118072,28855,2021-06-10 00:00:00,8144,163,제주특별자치도,126216,29018
9832337,2350687,2021-06-11 00:00:00,733067,285448,전국,10565404,2636135
1752249,380244,2021-06-11 00:00:00,148732,68440,서울특별시,1900981,448684
715397,141951,2021-06-11 00:00:00,52987,17505,부산광역시,768384,159456
403996,102439,2021-06-11 00:00:00,30502,10334,대구광역시,434498,112773
495548,109328,2021-06-11 00:00:00,40469,16148,인천광역시,536017,125476
262641,66069,2021-06-11 00:00:00,18393,7128,대전광역시,281034,73197
289213,76476,2021-06-11 00:00:00,18703,8678,광주광역시,307916,85154
2159117,495350,2021-06-11 00:00:00,170727,72261,경기도,2329844,567611
176346,39298,2021-06-11 00:00:00,16021,6954,울산광역시,192367,46252
365972,88190,2021-06-11 00:00:00,24754,7268,강원도,390726,95458
46349,11459,2021-06-11 00:00:00,4190,2279,세종특별자치시,50539,13738
354126,85713,2021-06-11 00:00:00,21981,7803,충청북도,376107,93516
458698,118475,2021-06-11 00:00:00,33926,10584,충청남도,492624,129059
467849,119636,2021-06-11 00:00:00,28484,9329,전라북도,496333,128965
520725,157021,2021-06-11 00:00:00,30401,9268,전라남도,551126,166289
576026,158026,2021-06-11 00:00:00,37572,10929,경상북도,613598,168955
661408,171991,2021-06-11 00:00:00,45241,16663,경상남도,706649,188654
126677,29021,2021-06-11 00:00:00,9984,3877,제주특별자치도,136661,32898
10594421,2638114,2021-06-12 00:00:00,792835,235748,전국,11387256,2873862
1905296,448992,2021-06-12 00:00:00,165265,55544,서울특별시,2070561,504536
769927,159656,2021-06-12 00:00:00,59838,14135,부산광역시,829765,173791
435914,112821,2021-06-12 00:00:00,33748,8542,대구광역시,469662,121363
537640,125539,2021-06-12 00:00:00,45600,13948,인천광역시,583240,139487
192967,46285,2021-06-12 00:00:00,15918,5356,울산광역시,208885,51641
308899,85396,2021-06-12 00:00:00,19935,7122,광주광역시,328834,92518
281841,73222,2021-06-12 00:00:00,19590,5483,대전광역시,301431,78705
50681,13745,2021-06-12 00:00:00,4386,1867,세종특별자치시,55067,15612
392499,95483,2021-06-12 00:00:00,25538,6849,강원도,418037,102332
377087,93634,2021-06-12 00:00:00,22939,6761,충청북도,400026,100395
2337842,568016,2021-06-12 00:00:00,194438,60128,경기도,2532280,628144
493776,129084,2021-06-12 00:00:00,34104,8891,충청남도,527880,137975
497151,128968,2021-06-12 00:00:00,28421,8170,전라북도,525572,137138
552339,166498,2021-06-12 00:00:00,29016,7260,전라남도,581355,173758
615067,168974,2021-06-12 00:00:00,38166,10226,경상북도,653233,179200
708413,188887,2021-06-12 00:00:00,46855,12753,경상남도,755268,201640
137082,32914,2021-06-12 00:00:00,9078,2713,제주특별자치도,146160,35627
11416064,2874527,2021-06-13 00:00:00,386223,117602,전국,11802287,2992129
2074678,504655,2021-06-13 00:00:00,82931,28724,서울특별시,2157609,533379
831273,173825,2021-06-13 00:00:00,28308,7512,부산광역시,859581,181337
471088,121414,2021-06-13 00:00:00,17108,4770,대구광역시,488196,126184
329758,92594,2021-06-13 00:00:00,10420,3618,광주광역시,340178,96212
584848,139503,2021-06-13 00:00:00,24123,5808,인천광역시,608971,145311
302174,78713,2021-06-13 00:00:00,8554,2611,대전광역시,310728,81324
209520,51653,2021-06-13 00:00:00,7079,2233,울산광역시,216599,53886
55267,15614,2021-06-13 00:00:00,2452,1069,세종특별자치시,57719,16683
2540515,628298,2021-06-13 00:00:00,108614,32130,경기도,2649129,660428
419798,102391,2021-06-13 00:00:00,8874,3104,강원도,428672,105495
401001,100403,2021-06-13 00:00:00,10918,2691,충청북도,411919,103094
529005,137983,2021-06-13 00:00:00,13609,4244,충청남도,542614,142227
526517,137143,2021-06-13 00:00:00,12452,3349,전라북도,538969,140492
582267,173850,2021-06-13 00:00:00,11852,3497,전라남도,594119,177347
654611,179210,2021-06-13 00:00:00,14195,4109,경상북도,668806,183319
757254,201651,2021-06-13 00:00:00,20750,6598,경상남도,778004,208249
146490,35627,2021-06-13 00:00:00,3984,1535,제주특별자치도,150474,37162
11802900,2992255,2021-06-14 00:00:00,27481,11774,전국,11830381,3004029
2157557,533408,2021-06-14 00:00:00,5702,2522,서울특별시,2163259,535930
859536,181339,2021-06-14 00:00:00,1329,504,부산광역시,860865,181843
488273,126219,2021-06-14 00:00:00,991,421,대구광역시,489264,126640
340156,96212,2021-06-14 00:00:00,228,100,광주광역시,340384,96312
609032,145312,2021-06-14 00:00:00,2013,875,인천광역시,611045,146187
57722,16683,2021-06-14 00:00:00,245,154,세종특별자치시,57967,16837
310703,81325,2021-06-14 00:00:00,986,538,대전광역시,311689,81863
216588,53888,2021-06-14 00:00:00,577,299,울산광역시,217165,54187
2649492,660476,2021-06-14 00:00:00,10053,3958,경기도,2659545,664434
428780,105499,2021-06-14 00:00:00,550,201,강원도,429330,105700
411970,103094,2021-06-14 00:00:00,631,160,충청북도,412601,103254
542607,142228,2021-06-14 00:00:00,1082,472,충청남도,543689,142700
538949,140494,2021-06-14 00:00:00,686,320,전라북도,539635,140814
594159,177347,2021-06-14 00:00:00,451,203,전라남도,594610,177550
668857,183320,2021-06-14 00:00:00,541,238,경상북도,669398,183558
778032,208249,2021-06-14 00:00:00,613,376,경상남도,778645,208625
150487,37162,2021-06-14 00:00:00,803,433,제주특별자치도,151290,37595
11833534,3006290,2021-06-15 00:00:00,731735,256443,전국,12565269,3262733
2164015,536472,2021-06-15 00:00:00,145519,52848,서울특별시,2309534,589320
861118,182046,2021-06-15 00:00:00,52456,15145,부산광역시,913574,197191
489379,126736,2021-06-15 00:00:00,33799,8476,대구광역시,523178,135212
611232,146292,2021-06-15 00:00:00,40208,13428,인천광역시,651440,159720
311723,81879,2021-06-15 00:00:00,19661,5554,대전광역시,331384,87433
340470,96430,2021-06-15 00:00:00,18346,7372,광주광역시,358816,103802
57990,16842,2021-06-15 00:00:00,4101,1633,세종특별자치시,62091,18475
217199,54259,2021-06-15 00:00:00,16436,5036,울산광역시,233635,59295
429391,105764,2021-06-15 00:00:00,23671,8361,강원도,453062,114125
412642,103356,2021-06-15 00:00:00,22038,8836,충청북도,434680,112192
2660539,665029,2021-06-15 00:00:00,176281,67631,경기도,2836820,732660
543767,142742,2021-06-15 00:00:00,30313,14024,충청남도,574080,156766
539733,140830,2021-06-15 00:00:00,24879,9646,전라북도,564612,150476
594725,177591,2021-06-15 00:00:00,26401,8898,전라남도,621126,186489
669480,183664,2021-06-15 00:00:00,41347,9496,경상북도,710827,193160
778736,208685,2021-06-15 00:00:00,47138,17216,경상남도,825874,225901
151395,37673,2021-06-15 00:00:00,9141,2843,제주특별자치도,160536,40516
12602026,3265037,2021-06-16 00:00:00,617181,207339,전국,13219207,3472376
2315468,590021,2021-06-16 00:00:00,122487,37687,서울특별시,2437955,627708
915656,197345,2021-06-16 00:00:00,42517,14094,부산광역시,958173,211439
524991,135300,2021-06-16 00:00:00,30390,7105,대구광역시,555381,142405
653429,159912,2021-06-16 00:00:00,33488,10952,인천광역시,686917,170864
359944,103863,2021-06-16 00:00:00,15277,4816,광주광역시,375221,108679
234317,59336,2021-06-16 00:00:00,14265,4606,울산광역시,248582,63942
62316,18477,2021-06-16 00:00:00,3159,1026,세종특별자치시,65475,19503
332460,87481,2021-06-16 00:00:00,16987,4643,대전광역시,349447,92124
2846847,733198,2021-06-16 00:00:00,144559,52782,경기도,2991406,785980
455006,114188,2021-06-16 00:00:00,21470,7105,강원도,476476,121293
435853,112211,2021-06-16 00:00:00,18885,7812,충청북도,454738,120023
575399,156806,2021-06-16 00:00:00,26150,11080,충청남도,601549,167886
565840,150489,2021-06-16 00:00:00,19746,9821,전라북도,585586,160310
622432,186602,2021-06-16 00:00:00,21776,6514,전라남도,644208,193116
712529,193232,2021-06-16 00:00:00,38378,8642,경상북도,750907,201874
828546,226016,2021-06-16 00:00:00,39367,15352,경상남도,867913,241368
160993,40560,2021-06-16 00:00:00,8280,3302,제주특별자치도,169273,43862
13250593,3474112,2021-06-17 00:00:00,540248,280928,전국,13790841,3755040
2442498,628123,2021-06-17 00:00:00,112311,57409,서울특별시,2554809,685532
959918,211561,2021-06-17 00:00:00,36253,18529,부산광역시,996171,230090
556934,142487,2021-06-17 00:00:00,25975,10780,대구광역시,582909,153267
688555,170937,2021-06-17 00:00:00,28579,14611,인천광역시,717134,185548
376225,108709,2021-06-17 00:00:00,11904,6785,광주광역시,388129,115494
249243,63985,2021-06-17 00:00:00,12961,5894,울산광역시,262204,69879
350303,92170,2021-06-17 00:00:00,15330,7963,대전광역시,365633,100133
65710,19509,2021-06-17 00:00:00,3061,1642,세종특별자치시,68771,21151
3000384,786687,2021-06-17 00:00:00,128857,72263,경기도,3129241,858950
478207,121332,2021-06-17 00:00:00,18698,8863,강원도,496905,130195
455836,120032,2021-06-17 00:00:00,15673,8754,충청북도,471509,128786
602704,167962,2021-06-17 00:00:00,22282,11975,충청남도,624986,179937
586602,160316,2021-06-17 00:00:00,16500,11473,전라북도,603102,171789
645309,193134,2021-06-17 00:00:00,17102,10723,전라남도,662411,203857
752490,201897,2021-06-17 00:00:00,33226,11742,경상북도,785716,213639
870019,241403,2021-06-17 00:00:00,34198,17803,경상남도,904217,259206
169656,43868,2021-06-17 00:00:00,7338,3719,제주특별자치도,176994,47587
13820058,3757067,2021-06-18 00:00:00,412987,127643,전국,14233045,3884710
2559654,685941,2021-06-18 00:00:00,78339,25631,서울특별시,2637993,711572
997654,230317,2021-06-18 00:00:00,27464,11352,부산광역시,1025118,241669
584151,153350,2021-06-18 00:00:00,21896,5453,대구광역시,606047,158803
366427,100146,2021-06-18 00:00:00,11468,3760,대전광역시,377895,103906
718702,185796,2021-06-18 00:00:00,22238,5885,인천광역시,740940,191681
389000,115523,2021-06-18 00:00:00,9333,3168,광주광역시,398333,118691
262845,69886,2021-06-18 00:00:00,9795,1628,울산광역시,272640,71514
3137267,859606,2021-06-18 00:00:00,92747,29204,경기도,3230014,888810
498744,130224,2021-06-18 00:00:00,16264,5470,강원도,515008,135694
68925,21153,2021-06-18 00:00:00,2268,741,세종특별자치시,71193,21894
472373,128809,2021-06-18 00:00:00,12503,3750,충청북도,484876,132559
626087,179982,2021-06-18 00:00:00,17373,5371,충청남도,643460,185353
604004,171806,2021-06-18 00:00:00,13334,5555,전라북도,617338,177361
663584,203903,2021-06-18 00:00:00,14594,5502,전라남도,678178,209405
787223,213744,2021-06-18 00:00:00,30242,6884,경상북도,817465,220628
906064,259258,2021-06-18 00:00:00,27307,6571,경상남도,933371,265829
177354,47623,2021-06-18 00:00:00,5822,1718,제주특별자치도,183176,49341
14261046,3886535,2021-06-19 00:00:00,507319,126036,전국,14768365,4012571
2642132,711868,2021-06-19 00:00:00,90850,27755,서울특별시,2732982,739623
1026549,241766,2021-06-19 00:00:00,37014,11420,부산광역시,1063563,253186
607187,158899,2021-06-19 00:00:00,20506,5640,대구광역시,627693,164539
742623,191726,2021-06-19 00:00:00,28414,6328,인천광역시,771037,198054
399214,118702,2021-06-19 00:00:00,13318,2914,광주광역시,412532,121616
273239,71556,2021-06-19 00:00:00,11321,1926,울산광역시,284560,73482
71349,21926,2021-06-19 00:00:00,2852,811,세종특별자치시,74201,22737
378713,103942,2021-06-19 00:00:00,12756,4690,대전광역시,391469,108632
516654,135771,2021-06-19 00:00:00,17566,5896,강원도,534220,141667
485789,132574,2021-06-19 00:00:00,16241,2653,충청북도,502030,135227
3237860,889308,2021-06-19 00:00:00,119905,28944,경기도,3357765,918252
644547,185397,2021-06-19 00:00:00,22586,5100,충청남도,667133,190497
618209,177435,2021-06-19 00:00:00,17913,4410,전라북도,636122,181845
679279,209649,2021-06-19 00:00:00,21129,4112,전라남도,700408,213761
818889,220761,2021-06-19 00:00:00,32984,6468,경상북도,851873,227229
935215,265892,2021-06-19 00:00:00,36161,4934,경상남도,971376,270826
183598,49363,2021-06-19 00:00:00,5803,2035,제주특별자치도,189401,51398
14800465,4013089,2021-06-20 00:00:00,211990,33522,전국,15012455,4046611
2738330,739768,2021-06-20 00:00:00,36213,7884,서울특별시,2774543,747652
1065192,253265,2021-06-20 00:00:00,16308,2097,부산광역시,1081500,255362
629040,164595,2021-06-20 00:00:00,5542,2268,대구광역시,634582,166863
772909,198073,2021-06-20 00:00:00,13675,1500,인천광역시,786584,199573
285172,73493,2021-06-20 00:00:00,4344,472,울산광역시,289516,73965
413448,121627,2021-06-20 00:00:00,6671,778,광주광역시,420119,122405
74389,22737,2021-06-20 00:00:00,1597,261,세종특별자치시,75986,22998
392477,108658,2021-06-20 00:00:00,4821,776,대전광역시,397298,109434
3367032,918355,2021-06-20 00:00:00,56847,11363,경기도,3423879,929718
536233,141683,2021-06-20 00:00:00,5126,517,강원도,541359,142200
503087,135228,2021-06-20 00:00:00,7270,635,충청북도,510357,135863
668370,190532,2021-06-20 00:00:00,8791,1347,충청남도,677161,191879
637125,181848,2021-06-20 00:00:00,8409,250,전라북도,645534,182098
701445,213761,2021-06-20 00:00:00,8483,656,전라남도,709928,214417
853331,227239,2021-06-20 00:00:00,10589,916,경상북도,863920,228155
973134,270829,2021-06-20 00:00:00,14691,1543,경상남도,987825,272372
189751,51398,2021-06-20 00:00:00,2613,259,제주특별자치도,192364,51657
15014314,4046808,2021-06-21 00:00:00,505,1038,전국,15014819,4047846
2774731,747815,2021-06-21 00:00:00,66,65,서울특별시,2774797,747880
1081640,255362,2021-06-21 00:00:00,17,17,부산광역시,1081657,255379
634591,166863,2021-06-21 00:00:00,151,0,대구광역시,634742,166863
786667,199602,2021-06-21 00:00:00,35,35,인천광역시,786702,199637
420126,122405,2021-06-21 00:00:00,0,0,광주광역시,420126,122405
397277,109434,2021-06-21 00:00:00,8,7,대전광역시,397285,109441
289575,73965,2021-06-21 00:00:00,1,0,울산광역시,289576,73965
76039,22998,2021-06-21 00:00:00,0,0,세종특별자치시,76039,22998
3424306,929720,2021-06-21 00:00:00,114,828,경기도,3424420,930548
541569,142203,2021-06-21 00:00:00,6,6,강원도,541575,142209
510453,135863,2021-06-21 00:00:00,0,0,충청북도,510453,135863
677173,191879,2021-06-21 00:00:00,8,8,충청남도,677181,191887
645571,182098,2021-06-21 00:00:00,0,0,전라북도,645571,182098
709968,214417,2021-06-21 00:00:00,36,36,전라남도,710004,214453
864073,228155,2021-06-21 00:00:00,24,0,경상북도,864097,228155
988143,272372,2021-06-21 00:00:00,3,0,경상남도,988146,272372
192412,51657,2021-06-21 00:00:00,36,36,제주특별자치도,192448,51693
15019767,4051080,2021-06-22 00:00:00,20231,116453,전국,15039998,4167533
2776635,749049,2021-06-22 00:00:00,4973,21087,서울특별시,2781608,770136
1081863,255532,2021-06-22 00:00:00,1207,9621,부산광역시,1083070,265153
634856,166991,2021-06-22 00:00:00,946,4578,대구광역시,635802,171569
786968,199836,2021-06-22 00:00:00,1425,5980,인천광역시,788393,205816
397370,109462,2021-06-22 00:00:00,578,3203,대전광역시,397948,112665
420170,122422,2021-06-22 00:00:00,585,2782,광주광역시,420755,125204
76049,23003,2021-06-22 00:00:00,164,275,세종특별자치시,76213,23278
289639,73999,2021-06-22 00:00:00,390,1597,울산광역시,290029,75596
3425742,931601,2021-06-22 00:00:00,4416,23561,경기도,3430158,955162
541744,142217,2021-06-22 00:00:00,621,3855,강원도,542365,146072
510573,135878,2021-06-22 00:00:00,741,5471,충청북도,511314,141349
677249,191962,2021-06-22 00:00:00,676,6769,충청남도,677925,198731
645656,182132,2021-06-22 00:00:00,594,5937,전라북도,646250,188069
710109,214498,2021-06-22 00:00:00,534,4464,전라남도,710643,218962
864261,228264,2021-06-22 00:00:00,874,7993,경상북도,865135,236257
988280,272419,2021-06-22 00:00:00,1166,7181,경상남도,989446,279600
192603,51815,2021-06-22 00:00:00,341,2099,제주특별자치도,192944,53914
15068519,4168857,2021-06-23 00:00:00,30346,123415,전국,15098865,4292272
2785966,770347,2021-06-23 00:00:00,6694,21120,서울특별시,2792660,791467
1084872,265190,2021-06-23 00:00:00,2035,9979,부산광역시,1086907,275169
637033,171603,2021-06-23 00:00:00,1388,4760,대구광역시,638421,176363
789992,205918,2021-06-23 00:00:00,1676,6321,인천광역시,791668,212239
421632,125225,2021-06-23 00:00:00,785,3409,광주광역시,422417,128634
290682,75605,2021-06-23 00:00:00,601,1449,울산광역시,291283,77054
398956,112673,2021-06-23 00:00:00,785,3413,대전광역시,399741,116086
76397,23291,2021-06-23 00:00:00,193,227,세종특별자치시,76590,23518
3437434,955688,2021-06-23 00:00:00,6221,23541,경기도,3443655,979229
543496,146075,2021-06-23 00:00:00,1271,4213,강원도,544767,150288
512183,141349,2021-06-23 00:00:00,937,5863,충청북도,513120,147212
679153,198845,2021-06-23 00:00:00,1235,7476,충청남도,680388,206321
647184,188070,2021-06-23 00:00:00,1062,6533,전라북도,648246,194603
711735,219019,2021-06-23 00:00:00,1123,6476,전라남도,712858,225495
866533,236381,2021-06-23 00:00:00,2187,8947,경상북도,868720,245328
991938,279656,2021-06-23 00:00:00,1775,7867,경상남도,993713,287523
193333,53922,2021-06-23 00:00:00,378,1821,제주특별자치도,193711,55743
15121636,4294377,2021-06-24 00:00:00,28485,119117,전국,15150121,4413494
2796229,791618,2021-06-24 00:00:00,5777,22048,서울특별시,2802006,813666
1087894,275350,2021-06-24 00:00:00,1946,9813,부산광역시,1089840,285163
639214,176382,2021-06-24 00:00:00,1899,5413,대구광역시,641113,181795
423246,128848,2021-06-24 00:00:00,396,2998,광주광역시,423642,131846
792922,212345,2021-06-24 00:00:00,1453,6659,인천광역시,794375,219004
400285,116096,2021-06-24 00:00:00,1113,3156,대전광역시,401398,119252
291736,77055,2021-06-24 00:00:00,537,1300,울산광역시,292273,78355
76757,23518,2021-06-24 00:00:00,154,276,세종특별자치시,76911,23794
3450264,980040,2021-06-24 00:00:00,6281,23431,경기도,3456545,1003471
545843,150379,2021-06-24 00:00:00,782,4679,강원도,546625,155058
513762,147267,2021-06-24 00:00:00,967,4680,충청북도,514729,151947
681455,206379,2021-06-24 00:00:00,1473,5348,충청남도,682928,211727
649016,194608,2021-06-24 00:00:00,938,6473,전라북도,649954,201081
714010,225732,2021-06-24 00:00:00,1135,6059,전라남도,715145,231791
869775,245343,2021-06-24 00:00:00,1173,9463,경상북도,870948,254806
995281,287617,2021-06-24 00:00:00,2084,5804,경상남도,997365,293421
193947,55800,2021-06-24 00:00:00,377,1517,제주특별자치도,194324,57317
15168599,4414987,2021-06-25 00:00:00,31320,106798,전국,15199919,4521785
2804610,813838,2021-06-25 00:00:00,6581,22040,서울특별시,2811191,835878
1091080,285213,2021-06-25 00:00:00,1861,9523,부산광역시,1092941,294736
641918,181828,2021-06-25 00:00:00,2312,5276,대구광역시,644230,187104
795272,219057,2021-06-25 00:00:00,1467,5678,인천광역시,796739,224735
401964,119280,2021-06-25 00:00:00,1138,3277,대전광역시,403102,122557
424335,131889,2021-06-25 00:00:00,928,2457,광주광역시,425263,134346
292748,78355,2021-06-25 00:00:00,719,1350,울산광역시,293467,79705
77013,23794,2021-06-25 00:00:00,206,162,세종특별자치시,77219,23956
3461601,1004372,2021-06-25 00:00:00,7696,22207,경기도,3469297,1026579
547443,155079,2021-06-25 00:00:00,1019,4114,강원도,548462,159193
515364,151954,2021-06-25 00:00:00,1351,3106,충청북도,516715,155060
683696,211765,2021-06-25 00:00:00,1583,3905,충청남도,685279,215670
650664,201108,2021-06-25 00:00:00,777,5071,전라북도,651441,206179
716003,231824,2021-06-25 00:00:00,952,4494,전라남도,716955,236318
871795,254845,2021-06-25 00:00:00,859,8310,경상북도,872654,263155
998468,293462,2021-06-25 00:00:00,1542,4205,경상남도,1000010,297667
194625,57324,2021-06-25 00:00:00,329,1623,제주특별자치도,194954,58947
15216892,4522789,2021-06-26 00:00:00,46333,96129,전국,15263225,4618918
2813647,835977,2021-06-26 00:00:00,7635,22720,서울특별시,2821282,858697
1093983,294745,2021-06-26 00:00:00,2879,9589,부산광역시,1096862,304334
644976,187104,2021-06-26 00:00:00,3196,5087,대구광역시,648172,192191
797686,224766,2021-06-26 00:00:00,2188,5697,인천광역시,799874,230463
403617,122565,2021-06-26 00:00:00,1704,3247,대전광역시,405321,125812
425822,134385,2021-06-26 00:00:00,1836,1709,광주광역시,427658,136094
77352,23956,2021-06-26 00:00:00,285,251,세종특별자치시,77637,24207
293818,79724,2021-06-26 00:00:00,1341,1004,울산광역시,295159,80728
3474009,1027019,2021-06-26 00:00:00,11730,18943,경기도,3485739,1045962
549156,159194,2021-06-26 00:00:00,1577,3380,강원도,550733,162574
517301,155152,2021-06-26 00:00:00,1405,1168,충청북도,518706,156320
686065,215861,2021-06-26 00:00:00,1935,3104,충청남도,688000,218965
651974,206179,2021-06-26 00:00:00,1381,4120,전라북도,653355,210299
717577,236341,2021-06-26 00:00:00,1733,3410,전라남도,719310,239751
873392,263158,2021-06-26 00:00:00,1661,7312,경상북도,875053,270470
1001369,297716,2021-06-26 00:00:00,3177,4168,경상남도,1004546,301884
195148,58947,2021-06-26 00:00:00,670,1220,제주특별자치도,195818,60167
15279057,4620427,2021-06-27 00:00:00,11159,22784,전국,15290216,4643211
2823669,858740,2021-06-27 00:00:00,2216,6655,서울특별시,2825885,865395
1097671,304334,2021-06-27 00:00:00,336,1119,부산광역시,1098007,305453
649040,192224,2021-06-27 00:00:00,484,512,대구광역시,649524,192736
800720,230464,2021-06-27 00:00:00,540,639,인천광역시,801260,231103
428199,136094,2021-06-27 00:00:00,427,424,광주광역시,428626,136518
405765,125812,2021-06-27 00:00:00,61,16,대전광역시,405826,125828
295548,80784,2021-06-27 00:00:00,48,0,울산광역시,295596,80784
77728,24207,2021-06-27 00:00:00,84,113,세종특별자치시,77812,24320
3490051,1046499,2021-06-27 00:00:00,3852,10274,경기도,3493903,1056773
551518,162600,2021-06-27 00:00:00,151,396,강원도,551669,162996
519240,156351,2021-06-27 00:00:00,158,1007,충청북도,519398,157358
688536,219023,2021-06-27 00:00:00,596,18,충청남도,689132,219041
653968,210299,2021-06-27 00:00:00,31,133,전라북도,653999,210432
719939,239752,2021-06-27 00:00:00,90,368,전라남도,720029,240120
875850,270545,2021-06-27 00:00:00,932,539,경상북도,876782,271084
1005644,302533,2021-06-27 00:00:00,688,505,경상남도,1006332,303038
195971,60166,2021-06-27 00:00:00,465,66,제주특별자치도,196436,60232
15290296,4643211,2021-06-28 00:00:00,6,740,전국,15290302,4643951
2825862,865395,2021-06-28 00:00:00,0,0,서울특별시,2825862,865395
1098001,305453,2021-06-28 00:00:00,0,0,부산광역시,1098001,305453
649515,192736,2021-06-28 00:00:00,0,0,대구광역시,649515,192736
428623,136518,2021-06-28 00:00:00,0,0,광주광역시,428623,136518
801294,231103,2021-06-28 00:00:00,0,0,인천광역시,801294,231103
405803,125828,2021-06-28 00:00:00,0,0,대전광역시,405803,125828
295592,80784,2021-06-28 00:00:00,0,0,울산광역시,295592,80784
77818,24320,2021-06-28 00:00:00,0,0,세종특별자치시,77818,24320
3493965,1056773,2021-06-28 00:00:00,0,734,경기도,3493965,1057507
551695,162996,2021-06-28 00:00:00,0,0,강원도,551695,162996
519405,157358,2021-06-28 00:00:00,0,0,충청북도,519405,157358
689111,219041,2021-06-28 00:00:00,0,0,충청남도,689111,219041
653998,210432,2021-06-28 00:00:00,0,0,전라북도,653998,210432
720059,240120,2021-06-28 00:00:00,6,6,전라남도,720065,240126
876789,271084,2021-06-28 00:00:00,0,0,경상북도,876789,271084
1006330,303038,2021-06-28 00:00:00,0,0,경상남도,1006330,303038
196436,60232,2021-06-28 00:00:00,0,0,제주특별자치도,196436,60232
15291417,4645673,2021-06-29 00:00:00,12703,112722,전국,15304120,4758395
2826063,865655,2021-06-29 00:00:00,3278,21853,서울특별시,2829341,887508
1098048,305584,2021-06-29 00:00:00,700,9246,부산광역시,1098748,314830
649532,192789,2021-06-29 00:00:00,633,4402,대구광역시,650165,197191
801622,231128,2021-06-29 00:00:00,846,5579,인천광역시,802468,236707
405825,125856,2021-06-29 00:00:00,863,2940,대전광역시,406688,128796
428632,136533,2021-06-29 00:00:00,566,2819,광주광역시,429198,139352
77828,24327,2021-06-29 00:00:00,40,174,세종특별자치시,77868,24501
3494172,1058102,2021-06-29 00:00:00,1840,20533,경기도,3496012,1078635
295598,80830,2021-06-29 00:00:00,139,1418,울산광역시,295737,82248
551707,163010,2021-06-29 00:00:00,484,4030,강원도,552191,167040
519425,157520,2021-06-29 00:00:00,273,5161,충청북도,519698,162681
689147,219115,2021-06-29 00:00:00,334,5920,충청남도,689481,225035
654008,210445,2021-06-29 00:00:00,560,5086,전라북도,654568,215531
720089,240143,2021-06-29 00:00:00,187,4820,전라남도,720276,244963
876817,271177,2021-06-29 00:00:00,787,9265,경상북도,877604,280442
1006463,303222,2021-06-29 00:00:00,967,8074,경상남도,1007430,311296
196441,60237,2021-06-29 00:00:00,206,1402,제주특별자치도,196647,61639
15305170,4789232,2021-06-30 00:00:00,16084,116230,전국,15321254,4905462
2829729,892112,2021-06-30 00:00:00,3321,22407,서울특별시,2833050,914519
1098790,316480,2021-06-30 00:00:00,1636,10349,부산광역시,1100426,326829
650183,198549,2021-06-30 00:00:00,1004,4552,대구광역시,651187,203101
429228,140254,2021-06-30 00:00:00,536,3401,광주광역시,429764,143655
802529,238396,2021-06-30 00:00:00,485,5091,인천광역시,803014,243487
406694,129719,2021-06-30 00:00:00,730,2802,대전광역시,407424,132521
77870,24683,2021-06-30 00:00:00,96,171,세종특별자치시,77966,24854
295748,82800,2021-06-30 00:00:00,388,1732,울산광역시,296136,84532
3496252,1087605,2021-06-30 00:00:00,2335,21221,경기도,3498587,1108826
552213,168817,2021-06-30 00:00:00,659,4217,강원도,552872,173034
519715,163708,2021-06-30 00:00:00,441,4569,충청북도,520156,168277
689519,226196,2021-06-30 00:00:00,527,6195,충청남도,690046,232391
654604,216506,2021-06-30 00:00:00,1279,6027,전라북도,655883,222533
720361,245984,2021-06-30 00:00:00,444,5131,전라남도,720805,251115
877628,282265,2021-06-30 00:00:00,590,8166,경상북도,878218,290431
1007455,313183,2021-06-30 00:00:00,1477,8915,경상남도,1008932,322098
196652,61975,2021-06-30 00:00:00,136,1284,제주특별자치도,196788,63259
15322128,4933545,2021-07-01 00:00:00,14233,107695,전국,15336361,5041240
2833265,918609,2021-07-01 00:00:00,3893,22749,서울특별시,2837158,941358
1100470,328272,2021-07-01 00:00:00,1144,9597,부산광역시,1101614,337869
651183,204407,2021-07-01 00:00:00,754,5200,대구광역시,651937,209607
803053,244956,2021-07-01 00:00:00,608,4945,인천광역시,803661,249901
429772,144513,2021-07-01 00:00:00,160,2639,광주광역시,429932,147152
407618,133336,2021-07-01 00:00:00,549,2233,대전광역시,408167,135569
296172,85083,2021-07-01 00:00:00,267,1956,울산광역시,296439,87039
77972,25038,2021-07-01 00:00:00,36,202,세종특별자치시,78008,25240
3498755,1117089,2021-07-01 00:00:00,2508,20602,경기도,3501263,1137691
552879,174584,2021-07-01 00:00:00,650,4017,강원도,553529,178601
520185,169284,2021-07-01 00:00:00,430,3552,충청북도,520615,172836
690069,233367,2021-07-01 00:00:00,335,6119,충청남도,690404,239486
655893,223407,2021-07-01 00:00:00,441,4615,전라북도,656334,228022
720869,252210,2021-07-01 00:00:00,649,3720,전라남도,721518,255930
878242,291980,2021-07-01 00:00:00,292,6738,경상북도,878534,298718
1008942,323805,2021-07-01 00:00:00,916,7291,경상남도,1009858,331096
196789,63605,2021-07-01 00:00:00,601,1520,제주특별자치도,197390,65125
15336784,5069914,2021-07-02 00:00:00,4043,86635,전국,15340827,5156549
2837213,945491,2021-07-02 00:00:00,1642,18865,서울특별시,2838855,964356
1101654,339384,2021-07-02 00:00:00,431,8869,부산광역시,1102085,348253
651943,210944,2021-07-02 00:00:00,79,3925,대구광역시,652022,214869
803699,251379,2021-07-02 00:00:00,76,4687,인천광역시,803775,256066
408173,136337,2021-07-02 00:00:00,42,1307,대전광역시,408215,137644
429941,148043,2021-07-02 00:00:00,139,429,광주광역시,430080,148472
78022,25388,2021-07-02 00:00:00,8,273,세종특별자치시,78030,25661
296446,87731,2021-07-02 00:00:00,26,1564,울산광역시,296472,89295
3501355,1145756,2021-07-02 00:00:00,378,17669,경기도,3501733,1163425
553551,180341,2021-07-02 00:00:00,121,3542,강원도,553672,183883
520638,174040,2021-07-02 00:00:00,51,1775,충청북도,520689,175815
690425,240525,2021-07-02 00:00:00,89,5302,충청남도,690514,245827
656341,228927,2021-07-02 00:00:00,114,4330,전라북도,656455,233257
721530,256785,2021-07-02 00:00:00,161,3912,전라남도,721691,260697
878569,300273,2021-07-02 00:00:00,127,4589,경상북도,878696,304862
1009876,333109,2021-07-02 00:00:00,151,4669,경상남도,1010027,337778
197408,65461,2021-07-02 00:00:00,408,928,제주특별자치도,197816,66389
15341363,5188067,2021-07-03 00:00:00,3930,83700,전국,15345293,5271767
2838882,968846,2021-07-03 00:00:00,1588,20529,서울특별시,2840470,989375
1102113,349883,2021-07-03 00:00:00,478,9181,부산광역시,1102591,359064
652032,216383,2021-07-03 00:00:00,343,3614,대구광역시,652375,219997
803796,257973,2021-07-03 00:00:00,96,5091,인천광역시,803892,263064
408219,138558,2021-07-03 00:00:00,60,1420,대전광역시,408279,139978
430100,149515,2021-07-03 00:00:00,128,386,광주광역시,430228,149901
296505,89918,2021-07-03 00:00:00,78,1224,울산광역시,296583,91142
78031,25854,2021-07-03 00:00:00,11,280,세종특별자치시,78042,26134
3501862,1172265,2021-07-03 00:00:00,353,18250,경기도,3502215,1190515
553685,185706,2021-07-03 00:00:00,82,3251,강원도,553767,188957
520708,176832,2021-07-03 00:00:00,48,1809,충청북도,520756,178641
656463,234244,2021-07-03 00:00:00,236,2853,전라북도,656699,237097
690537,247054,2021-07-03 00:00:00,104,4844,충청남도,690641,251898
721800,262037,2021-07-03 00:00:00,131,2558,전라남도,721931,264595
878760,306536,2021-07-03 00:00:00,41,3953,경상북도,878801,310489
1010050,339587,2021-07-03 00:00:00,107,3574,경상남도,1010157,343161
197820,66876,2021-07-03 00:00:00,46,883,제주특별자치도,197866,67759
15346047,5303295,2021-07-04 00:00:00,1150,16659,전국,15347197,5319954
2840542,993799,2021-07-04 00:00:00,696,4139,서울특별시,2841238,997938
1102686,360735,2021-07-04 00:00:00,71,503,부산광역시,1102757,361238
652416,221524,2021-07-04 00:00:00,28,905,대구광역시,652444,222429
803937,264767,2021-07-04 00:00:00,17,1525,인천광역시,803954,266292
408310,140863,2021-07-04 00:00:00,1,0,대전광역시,408311,140863
430247,150809,2021-07-04 00:00:00,84,60,광주광역시,430331,150869
78046,26337,2021-07-04 00:00:00,4,95,세종특별자치시,78050,26432
296604,91806,2021-07-04 00:00:00,2,40,울산광역시,296606,91846
3502354,1199718,2021-07-04 00:00:00,122,7776,경기도,3502476,1207494
553799,190965,2021-07-04 00:00:00,11,327,강원도,553810,191292
520768,179694,2021-07-04 00:00:00,23,20,충청북도,520791,179714
690660,253099,2021-07-04 00:00:00,27,661,충청남도,690687,253760
656719,238171,2021-07-04 00:00:00,0,9,전라북도,656719,238180
721957,265634,2021-07-04 00:00:00,1,242,전라남도,721958,265876
878840,311950,2021-07-04 00:00:00,0,21,경상북도,878840,311971
1010285,345269,2021-07-04 00:00:00,39,336,경상남도,1010324,345605
197877,68155,2021-07-04 00:00:00,24,0,제주특별자치도,197901,68155
15347214,5320977,2021-07-05 00:00:00,0,625,전국,15347214,5321602
2841244,998134,2021-07-05 00:00:00,0,0,서울특별시,2841244,998134
1102757,361274,2021-07-05 00:00:00,0,0,부산광역시,1102757,361274
652441,222477,2021-07-05 00:00:00,0,0,대구광역시,652441,222477
803951,266335,2021-07-05 00:00:00,0,0,인천광역시,803951,266335
430333,150898,2021-07-05 00:00:00,0,0,광주광역시,430333,150898
296607,91872,2021-07-05 00:00:00,0,0,울산광역시,296607,91872
408318,140886,2021-07-05 00:00:00,0,0,대전광역시,408318,140886
78051,26439,2021-07-05 00:00:00,0,0,세종특별자치시,78051,26439
3502475,1207682,2021-07-05 00:00:00,0,625,경기도,3502475,1208307
553806,191314,2021-07-05 00:00:00,0,0,강원도,553806,191314
520793,179798,2021-07-05 00:00:00,0,0,충청북도,520793,179798
690686,253782,2021-07-05 00:00:00,0,0,충청남도,690686,253782
656719,238202,2021-07-05 00:00:00,0,0,전라북도,656719,238202
721957,265904,2021-07-05 00:00:00,0,0,전라남도,721957,265904
878842,312021,2021-07-05 00:00:00,0,0,경상북도,878842,312021
1010324,345785,2021-07-05 00:00:00,0,0,경상남도,1010324,345785
197910,68174,2021-07-05 00:00:00,0,0,제주특별자치도,197910,68174
